//MAP CONVERTED BY dmm2tgm.py THIS HEADER COMMENT PREVENTS RECONVERSION, DO NOT REMOVE
"a" = (
/turf/closed/wall/mineral/titanium,
/area/shuttle/supply)
"c" = (
/obj/effect/turf_decal/stripes/corner{
	dir = 8
	},
/turf/open/floor/plasteel/cargo,
/area/shuttle/supply)
"d" = (
/obj/effect/turf_decal/stripes/corner{
	dir = 8
	},
/turf/open/floor/mineral/titanium,
/area/shuttle/supply)
"e" = (
/turf/open/floor/mineral/titanium,
/area/shuttle/supply)
"g" = (
/obj/effect/turf_decal/stripes/line{
	dir = 6
	},
/obj/effect/turf_decal/tile/brown/opposingcorners,
/obj/effect/turf_decal/stripes/corner{
	dir = 1
	},
/turf/open/floor/mineral/titanium/yellow,
/area/shuttle/supply)
"h" = (
/obj/effect/turf_decal/stripes/corner,
/obj/effect/turf_decal/tile/brown/opposingcorners,
/obj/effect/turf_decal/stripes/line{
	dir = 1
	},
/turf/open/floor/mineral/titanium/yellow,
/area/shuttle/supply)
"i" = (
/obj/machinery/door/poddoor{
	id = "QMLoaddoor";
	name = "Supply Dock Loading Door"
	},
/obj/machinery/conveyor{
	dir = 8;
	id = "QMLoad";
	name = "off ramp"
	},
/obj/structure/fans/tiny,
/turf/open/floor/plating,
/area/shuttle/supply)
"j" = (
/obj/effect/turf_decal/loading_area{
	dir = 8
	},
/turf/open/floor/mineral/plastitanium,
/area/shuttle/supply)
"l" = (
/obj/effect/turf_decal/stripes/line{
	dir = 1
	},
/turf/open/floor/mineral/titanium,
/area/shuttle/supply)
"m" = (
/obj/machinery/door/airlock/shuttle{
	name = "Supply Shuttle Airlock";
	req_access_txt = "31"
	},
/obj/effect/decal/cleanable/dirt,
/obj/docking_port/mobile/supply{
	dir = 4;
	dwidth = 4
	},
/obj/structure/fans/tiny,
/turf/open/floor/mineral/plastitanium,
/area/shuttle/supply)
"n" = (
/obj/effect/turf_decal/stripes/corner,
/turf/open/floor/plasteel/cargo,
/area/shuttle/supply)
"q" = (
/obj/effect/turf_decal/stripes/corner{
	dir = 1
	},
/turf/open/floor/plasteel/cargo,
/area/shuttle/supply)
"r" = (
/obj/machinery/door/airlock/shuttle{
	name = "Supply Shuttle Airlock";
	req_access_txt = "31"
	},
/obj/effect/decal/cleanable/dirt,
/obj/structure/fans/tiny,
/turf/open/floor/mineral/plastitanium,
/area/shuttle/supply)
"s" = (
/obj/effect/turf_decal/stripes/corner{
	dir = 8
	},
/obj/effect/turf_decal/tile/brown/opposingcorners,
/obj/effect/turf_decal/stripes/line{
	dir = 1
	},
/turf/open/floor/mineral/titanium/yellow,
/area/shuttle/supply)
"t" = (
/obj/machinery/door/poddoor{
	id = "QMLoaddoor2";
	name = "Supply Dock Loading Door"
	},
/obj/machinery/conveyor{
	dir = 4;
	id = "QMLoad2";
	name = "on ramp"
	},
/obj/structure/fans/tiny,
/turf/open/floor/plating,
/area/shuttle/supply)
"u" = (
/obj/effect/turf_decal/loading_area{
	dir = 4
	},
/turf/open/floor/mineral/plastitanium,
/area/shuttle/supply)
"w" = (
/obj/structure/chair/fancy/shuttle{
	dir = 1
	},
/turf/open/floor/mineral/titanium,
/area/shuttle/supply)
"x" = (
/turf/open/floor/plasteel/cargo,
/area/shuttle/supply)
"y" = (
/obj/structure/sign/warning/fire,
/turf/closed/wall/mineral/titanium/nodiagonal,
/area/shuttle/supply)
"A" = (
/obj/effect/spawner/structure/window/shuttle,
/obj/structure/shuttle/engine/heater,
/turf/open/floor/plating,
/area/shuttle/supply)
"B" = (
/turf/template_noop,
/area/template_noop)
"C" = (
/obj/structure/shuttle/engine/propulsion/burst/left,
/obj/effect/turf_decal/stripes/line,
/turf/open/floor/plating/airless,
/area/shuttle/supply)
"D" = (
/obj/structure/shuttle/engine/propulsion,
/obj/effect/turf_decal/stripes/line,
/turf/open/floor/plating/airless,
/area/shuttle/supply)
"E" = (
/obj/structure/shuttle/engine/propulsion/burst/right,
/obj/effect/turf_decal/stripes/line,
/turf/open/floor/plating/airless,
/area/shuttle/supply)
"F" = (
/obj/effect/turf_decal/stripes/line{
	dir = 4
	},
/obj/machinery/light{
	dir = 4
	},
/obj/effect/turf_decal/tile/brown/opposingcorners,
/obj/effect/turf_decal/stripes/corner{
	dir = 8
	},
/turf/open/floor/mineral/titanium/yellow,
/area/shuttle/supply)
"G" = (
/obj/effect/turf_decal/stripes/line{
	dir = 4
	},
/obj/machinery/light{
	dir = 4
	},
/obj/effect/turf_decal/tile/brown/opposingcorners,
/obj/effect/turf_decal/stripes/line{
	dir = 8
	},
/turf/open/floor/mineral/titanium/yellow,
/area/shuttle/supply)
"H" = (
/obj/effect/turf_decal/tile/brown/opposingcorners,
/obj/effect/turf_decal/stripes/line,
/turf/open/floor/mineral/titanium/yellow,
/area/shuttle/supply)
"I" = (
/obj/effect/turf_decal/stripes/line{
	dir = 9
	},
/obj/effect/turf_decal/tile/brown/opposingcorners,
/turf/open/floor/mineral/titanium/yellow,
/area/shuttle/supply)
"J" = (
/obj/effect/turf_decal/stripes/line{
	dir = 4
	},
/obj/structure/sign/departments/cargo{
	pixel_x = 32
	},
/obj/effect/turf_decal/tile/brown/opposingcorners,
/obj/effect/turf_decal/stripes/line{
	dir = 8
	},
/turf/open/floor/mineral/titanium/yellow,
/area/shuttle/supply)
"K" = (
/obj/effect/turf_decal/stripes/line{
	dir = 1
	},
/obj/machinery/computer/cargo,
/turf/open/floor/mineral/titanium,
/area/shuttle/supply)
"L" = (
/obj/effect/turf_decal/stripes/corner{
	dir = 1
	},
/obj/effect/turf_decal/tile/brown/opposingcorners,
/obj/effect/turf_decal/stripes/line,
/turf/open/floor/mineral/titanium/yellow,
/area/shuttle/supply)
"M" = (
/obj/effect/turf_decal/stripes/corner{
	dir = 1
	},
/obj/effect/turf_decal/tile/brown/opposingcorners,
/obj/effect/turf_decal/stripes/line{
	dir = 6
	},
/turf/open/floor/mineral/titanium/yellow,
/area/shuttle/supply)
"N" = (
/obj/effect/turf_decal/stripes/end{
	dir = 8
	},
/obj/effect/turf_decal/tile/brown/opposingcorners,
/turf/open/floor/mineral/titanium/yellow,
/area/shuttle/supply)
"O" = (
/obj/effect/turf_decal/stripes/line{
	dir = 10
	},
/obj/effect/turf_decal/tile/brown/opposingcorners,
/turf/open/floor/mineral/titanium/yellow,
/area/shuttle/supply)
"P" = (
/obj/effect/turf_decal/stripes/line{
	dir = 4
	},
/obj/effect/turf_decal/tile/brown/opposingcorners,
/turf/open/floor/mineral/titanium/yellow,
/area/shuttle/supply)
"Q" = (
/obj/effect/turf_decal/stripes/corner{
	dir = 1
	},
/obj/effect/turf_decal/stripes/corner{
	dir = 8
	},
/turf/open/floor/plasteel/cargo,
/area/shuttle/supply)
"R" = (
/obj/effect/turf_decal/stripes/line{
	dir = 5
	},
/obj/effect/turf_decal/tile/brown/opposingcorners,
/turf/open/floor/mineral/titanium/yellow,
/area/shuttle/supply)
"S" = (
/obj/effect/turf_decal/stripes/line{
	dir = 6
	},
/obj/effect/turf_decal/tile/brown/opposingcorners,
/turf/open/floor/mineral/titanium/yellow,
/area/shuttle/supply)
"T" = (
/obj/effect/turf_decal/stripes/corner{
	dir = 4
	},
/turf/open/floor/plasteel/cargo,
/area/shuttle/supply)
"U" = (
/obj/effect/turf_decal/stripes/line{
	dir = 8
	},
/obj/machinery/button/door{
	id = "QMLoaddoor";
	layer = 4;
	name = "Off Ramp Toggle";
	pixel_x = -24;
	pixel_y = 6;
	req_access_txt = "31"
	},
/obj/machinery/button/door{
	id = "QMLoaddoor2";
	layer = 4;
	name = "On Ramp Toggle";
	pixel_x = -24;
	pixel_y = -6;
	req_access_txt = "31"
	},
/obj/effect/turf_decal/tile/brown/opposingcorners,
/obj/effect/turf_decal/stripes/line{
	dir = 4
	},
/turf/open/floor/mineral/titanium/yellow,
/area/shuttle/supply)
"V" = (
/obj/effect/turf_decal/stripes/corner{
	dir = 8
	},
/obj/effect/turf_decal/tile/brown/opposingcorners,
/obj/effect/turf_decal/stripes/line{
	dir = 5
	},
/turf/open/floor/mineral/titanium/yellow,
/area/shuttle/supply)
"W" = (
/obj/effect/turf_decal/stripes/line,
/obj/effect/turf_decal/tile/brown/opposingcorners,
/turf/open/floor/mineral/titanium/yellow,
/area/shuttle/supply)
"X" = (
/obj/effect/turf_decal/stripes/line{
	dir = 4
	},
/obj/effect/turf_decal/tile/brown/opposingcorners,
/obj/effect/turf_decal/stripes/line{
	dir = 8
	},
/turf/open/floor/mineral/titanium/yellow,
/area/shuttle/supply)
"Y" = (
/obj/effect/turf_decal/tile/brown/opposingcorners,
/obj/effect/turf_decal/stripes/line{
	dir = 1
	},
/turf/open/floor/mineral/titanium/yellow,
/area/shuttle/supply)

(1,1,1) = {"
a
a
a
i
m
a
r
t
a
a
a
B
"}
(2,1,1) = {"
a
I
O
j
V
U
M
u
N
y
a
C
"}
(3,1,1) = {"
a
l
d
L
q
x
c
Q
s
O
A
D
"}
(4,1,1) = {"
a
K
w
H
x
x
x
x
Y
W
A
D
"}
(5,1,1) = {"
a
l
e
H
T
x
x
n
h
S
A
D
"}
(6,1,1) = {"
a
R
P
F
X
J
X
G
g
y
a
E
"}
(7,1,1) = {"
a
a
a
a
a
a
a
a
a
a
a
B
"}
