//MAP CONVERTED BY dmm2tgm.py THIS HEADER COMMENT PREVENTS RECONVERSION, DO NOT REMOVE
"a" = (
/turf/closed/wall/mineral/titanium,
/area/shuttle/supply)
"c" = (
/obj/effect/turf_decal/stripes/line{
	dir = 1
	},
/turf/open/floor/plasteel,
/area/shuttle/supply)
"d" = (
/obj/effect/decal/cleanable/dirt,
/obj/effect/turf_decal/stripes/line{
	dir = 8
	},
/obj/effect/turf_decal/stripes/line{
	dir = 4
	},
/turf/open/floor/plasteel,
/area/shuttle/supply)
"i" = (
/obj/effect/decal/cleanable/dirt,
/obj/machinery/light/small{
	dir = 1
	},
/obj/machinery/computer/cargo,
/turf/open/floor/mineral/titanium,
/area/shuttle/supply)
"j" = (
/obj/effect/decal/cleanable/dirt,
/obj/effect/turf_decal/stripes/line{
	dir = 4
	},
/turf/open/floor/plasteel,
/area/shuttle/supply)
"k" = (
/obj/machinery/conveyor{
	dir = 8;
	id = "cargounload"
	},
/obj/machinery/door/poddoor{
	id = "cargounload";
	name = "supply dock unloading door"
	},
/obj/structure/fans/tiny,
/turf/open/floor/plating,
/area/shuttle/supply)
"m" = (
/obj/effect/turf_decal/stripes/line{
	dir = 4
	},
/turf/open/floor/plasteel,
/area/shuttle/supply)
"n" = (
/obj/machinery/door/airlock/shuttle{
	name = "Supply Shuttle Airlock";
	req_access_txt = "31"
	},
/obj/effect/decal/cleanable/dirt,
/obj/docking_port/mobile/supply{
	dir = 4;
	dwidth = 4
	},
/obj/structure/fans/tiny,
/turf/open/floor/plating,
/area/shuttle/supply)
"o" = (
/obj/effect/turf_decal/stripes/line{
	dir = 8
	},
/turf/open/floor/plasteel,
/area/shuttle/supply)
"p" = (
/obj/machinery/button/door{
	id = "cargounload";
	name = "Loading Doors";
	pixel_x = -24;
	pixel_y = 8
	},
/obj/machinery/button/door{
	id = "cargoload";
	name = "Loading Doors";
	pixel_x = -24;
	pixel_y = -8
	},
/obj/effect/turf_decal/stripes/line{
	dir = 8
	},
/obj/machinery/light{
	dir = 8
	},
/turf/open/floor/plasteel,
/area/shuttle/supply)
"q" = (
/obj/effect/turf_decal/stripes/line{
	dir = 4
	},
/obj/machinery/light{
	dir = 4
	},
/turf/open/floor/plasteel,
/area/shuttle/supply)
"r" = (
/obj/machinery/door/airlock/shuttle{
	name = "Supply Shuttle Airlock";
	req_access_txt = "31"
	},
/obj/effect/decal/cleanable/dirt,
/obj/structure/fans/tiny,
/turf/open/floor/plating,
/area/shuttle/supply)
"s" = (
/obj/machinery/door/poddoor{
	id = "cargoload";
	name = "supply dock loading door"
	},
/obj/machinery/conveyor{
	dir = 4;
	id = "cargoload"
	},
/obj/structure/fans/tiny,
/turf/open/floor/plating,
/area/shuttle/supply)
"t" = (
/obj/effect/decal/cleanable/dirt,
/obj/effect/turf_decal/stripes/line{
	dir = 10
	},
/turf/open/floor/plasteel,
/area/shuttle/supply)
"u" = (
/obj/effect/decal/cleanable/dirt,
/obj/effect/turf_decal/stripes/line,
/turf/open/floor/plasteel,
/area/shuttle/supply)
"v" = (
/obj/effect/turf_decal/stripes/line,
/turf/open/floor/plasteel,
/area/shuttle/supply)
"w" = (
/obj/effect/turf_decal/stripes/line{
	dir = 6
	},
/turf/open/floor/plasteel,
/area/shuttle/supply)
"x" = (
/obj/effect/decal/cleanable/dirt,
/obj/effect/turf_decal/delivery,
/turf/open/floor/plasteel,
/area/shuttle/supply)
"y" = (
/obj/effect/turf_decal/delivery,
/turf/open/floor/plasteel,
/area/shuttle/supply)
"z" = (
/obj/structure/window/reinforced{
	dir = 1
	},
/obj/structure/shuttle/engine/heater,
/obj/effect/turf_decal/stripes/line,
/turf/open/floor/plating/airless,
/area/shuttle/supply)
"A" = (
/obj/structure/window/reinforced{
	dir = 1
	},
/obj/structure/shuttle/engine/heater,
/obj/effect/decal/cleanable/dirt,
/obj/effect/turf_decal/stripes/line,
/turf/open/floor/plating/airless,
/area/shuttle/supply)
"B" = (
/turf/template_noop,
/area/template_noop)
"C" = (
/obj/structure/shuttle/engine/propulsion/burst/left,
/obj/effect/turf_decal/stripes/line,
/turf/open/floor/plating/airless,
/area/shuttle/supply)
"D" = (
/obj/structure/shuttle/engine/propulsion,
/obj/effect/turf_decal/stripes/line,
/turf/open/floor/plating/airless,
/area/shuttle/supply)
"E" = (
/obj/structure/shuttle/engine/propulsion/burst/right,
/obj/effect/turf_decal/stripes/line,
/turf/open/floor/plating/airless,
/area/shuttle/supply)
"I" = (
/obj/structure/chair/fancy/shuttle{
	dir = 1
	},
/turf/open/floor/mineral/titanium,
/area/shuttle/supply)
"J" = (
/obj/effect/decal/cleanable/dirt,
/turf/open/floor/mineral/titanium,
/area/shuttle/supply)
"L" = (
/turf/open/floor/mineral/titanium,
/area/shuttle/supply)
"N" = (
/turf/open/floor/plasteel/cargo,
/area/shuttle/supply)
"O" = (
/obj/effect/turf_decal/stripes/line{
	dir = 4
	},
/obj/effect/turf_decal/stripes/corner{
	dir = 1
	},
/turf/open/floor/plasteel,
/area/shuttle/supply)
"P" = (
/obj/effect/decal/cleanable/dirt,
/obj/effect/turf_decal/stripes/line{
	dir = 4
	},
/obj/effect/turf_decal/stripes/line{
	dir = 8
	},
/turf/open/floor/plasteel,
/area/shuttle/supply)
"Q" = (
/obj/effect/decal/cleanable/dirt,
/obj/effect/turf_decal/stripes/line{
	dir = 8
	},
/obj/effect/turf_decal/stripes/corner{
	dir = 4
	},
/turf/open/floor/plasteel,
/area/shuttle/supply)
"R" = (
/obj/effect/decal/cleanable/dirt,
/obj/effect/turf_decal/stripes/end{
	dir = 1
	},
/turf/open/floor/plasteel,
/area/shuttle/supply)
"X" = (
/obj/effect/turf_decal/stripes/end{
	dir = 1
	},
/turf/open/floor/plasteel,
/area/shuttle/supply)

(1,1,1) = {"
a
a
a
k
n
a
r
s
a
a
a
B
"}
(2,1,1) = {"
a
R
d
Q
o
p
o
o
t
a
a
C
"}
(3,1,1) = {"
a
L
L
c
N
N
N
N
u
x
z
D
"}
(4,1,1) = {"
a
i
I
c
N
N
N
N
v
x
A
D
"}
(5,1,1) = {"
a
J
L
c
N
N
N
N
v
y
A
D
"}
(6,1,1) = {"
a
X
P
O
j
q
m
j
w
a
a
E
"}
(7,1,1) = {"
a
a
a
a
a
a
a
a
a
a
a
B
"}
