//MAP CONVERTED BY dmm2tgm.py THIS HEADER COMMENT PREVENTS RECONVERSION, DO NOT REMOVE
"a" = (
/mob/living/simple_animal/hostile/megafauna/hierophant,
/turf/open/indestructible/hierophant/two,
/area/ruin/unpowered/hierophant)
"b" = (
/obj/effect/light_emitter{
	set_cap = 3;
	set_luminosity = 5
	},
/turf/open/indestructible/hierophant,
/area/ruin/unpowered/hierophant)
"k" = (
/turf/closed/indestructible/riveted/hierophant,
/area/ruin/unpowered/hierophant)
"m" = (
/obj/item/tank/internals/oxygen,
/turf/open/floor/plating/asteroid/airless,
/area/space)
"p" = (
/obj/item/clothing/suit/space/eva,
/turf/open/floor/plating/asteroid/airless,
/area/space)
"t" = (
/turf/open/indestructible/hierophant,
/area/ruin/unpowered/hierophant)
"A" = (
/obj/effect/light_emitter{
	set_cap = 3;
	set_luminosity = 5
	},
/turf/open/indestructible/hierophant/two,
/area/ruin/unpowered/hierophant)
"B" = (
/obj/structure/fans/tiny/invisible,
/turf/open/indestructible/hierophant,
/area/ruin/unpowered/hierophant)
"K" = (
/obj/item/pickaxe,
/turf/open/floor/plating/asteroid/airless,
/area/space)
"M" = (
/obj/effect/decal/remains/human,
/turf/open/floor/plating/asteroid/airless,
/area/space)
"Q" = (
/turf/open/indestructible/hierophant/two,
/area/ruin/unpowered/hierophant)
"S" = (
/turf/template_noop,
/area/template_noop)
"Y" = (
/turf/closed/mineral/random/high_chance,
/area/space)
"Z" = (
/turf/open/floor/plating/asteroid/airless,
/area/space)

(1,1,1) = {"
S
S
S
S
S
Y
Y
Y
Y
Y
Y
Y
Z
Z
Z
Z
Y
Y
Y
Y
Z
Z
Y
Y
Y
Y
S
S
S
"}
(2,1,1) = {"
S
S
S
Y
Y
Y
Y
Z
Z
M
m
Z
Z
Z
Z
Z
Z
Y
Z
Z
M
Z
Y
Y
Y
Y
Y
S
S
"}
(3,1,1) = {"
S
S
Y
Y
Y
Y
Z
Z
Z
Z
Z
Z
Z
M
Z
Z
Z
Z
Z
Z
Z
Z
Z
Y
Y
Y
Y
Y
S
"}
(4,1,1) = {"
S
Y
Y
k
k
k
B
B
B
B
k
k
k
k
k
k
k
k
k
B
B
B
B
k
k
k
Y
Y
Y
"}
(5,1,1) = {"
Y
Y
Y
k
t
t
t
t
t
t
t
t
t
t
b
t
t
t
t
t
t
t
t
t
t
k
Y
Y
Y
"}
(6,1,1) = {"
Y
Y
Y
k
t
t
t
b
b
t
t
t
k
t
t
t
k
t
t
t
b
b
t
t
t
k
Y
Y
Y
"}
(7,1,1) = {"
Y
Y
Z
B
t
t
t
t
t
t
t
t
t
t
t
t
t
t
t
t
t
t
t
t
t
B
Z
Z
Y
"}
(8,1,1) = {"
Y
Z
Z
B
t
b
t
k
k
t
b
t
t
t
b
t
t
t
b
t
k
k
t
b
t
B
M
Z
Z
"}
(9,1,1) = {"
Y
Z
Z
B
t
b
t
k
k
t
b
t
t
t
b
t
t
t
b
t
k
k
t
b
t
B
Z
Z
Z
"}
(10,1,1) = {"
Y
Z
Z
B
t
t
t
t
t
Q
Q
Q
Q
Q
Q
Q
Q
Q
Q
Q
t
t
t
t
t
B
Z
M
Z
"}
(11,1,1) = {"
Y
M
Z
k
t
t
t
b
b
Q
Q
Q
k
Q
Q
Q
k
Q
Q
Q
b
b
t
t
t
k
Z
Z
Y
"}
(12,1,1) = {"
Y
Z
Z
k
t
t
t
t
t
Q
Q
Q
Q
Q
A
Q
Q
Q
Q
Q
t
t
t
t
t
k
Y
Y
Y
"}
(13,1,1) = {"
Y
Z
Z
k
t
k
t
t
t
Q
k
Q
Q
Q
Q
Q
Q
Q
k
Q
t
t
t
k
t
k
Y
Y
Y
"}
(14,1,1) = {"
Y
Z
Z
k
t
t
t
t
t
Q
Q
Q
Q
Q
Q
Q
Q
Q
Q
Q
t
t
t
t
t
k
Y
Y
Y
"}
(15,1,1) = {"
Y
Z
Z
k
b
t
t
b
b
Q
Q
A
Q
Q
a
Q
Q
A
Q
Q
b
b
t
t
b
k
Y
Y
S
"}
(16,1,1) = {"
Y
Z
Z
k
t
t
t
t
t
Q
Q
Q
Q
Q
Q
Q
Q
Q
Q
Q
t
t
t
t
t
k
Y
Y
S
"}
(17,1,1) = {"
Y
Z
M
k
t
k
t
t
t
Q
k
Q
Q
Q
Q
Q
Q
Q
k
Q
t
t
t
k
t
k
Y
Y
S
"}
(18,1,1) = {"
Y
Y
Z
k
t
t
t
t
t
Q
Q
Q
Q
Q
A
Q
Q
Q
Q
Q
t
t
t
t
t
k
Y
Y
S
"}
(19,1,1) = {"
Y
Y
Z
k
t
t
t
b
b
Q
Q
Q
k
Q
Q
Q
k
Q
Q
Q
b
b
t
t
t
k
Y
Y
S
"}
(20,1,1) = {"
Y
Y
Z
B
t
t
t
t
t
Q
Q
Q
Q
Q
Q
Q
Q
Q
Q
Q
t
t
t
t
t
B
Z
Y
S
"}
(21,1,1) = {"
Y
Y
Z
B
t
b
t
k
k
t
b
t
t
t
b
t
t
t
b
t
k
k
t
b
t
B
Z
Y
Y
"}
(22,1,1) = {"
S
Y
Y
B
t
b
t
k
k
t
b
t
t
t
b
t
t
t
b
t
k
k
t
b
t
B
Z
Z
Y
"}
(23,1,1) = {"
S
Y
Y
B
t
t
t
t
t
t
t
t
t
t
t
t
t
t
t
t
t
t
t
t
t
B
M
K
Y
"}
(24,1,1) = {"
S
Y
Y
k
t
t
t
b
b
t
t
t
k
t
t
t
k
t
t
t
b
b
t
t
t
k
Z
Z
Y
"}
(25,1,1) = {"
S
S
Y
k
t
t
t
t
t
t
t
t
t
t
b
t
t
t
t
t
t
t
t
t
t
k
Z
Y
Y
"}
(26,1,1) = {"
S
S
Y
k
k
k
B
B
B
B
k
k
k
k
k
k
k
k
k
B
B
B
B
k
k
k
p
Y
Y
"}
(27,1,1) = {"
S
S
Y
Y
Y
Y
Z
Z
Z
Z
Z
Y
Y
Y
Y
Y
Y
Y
Z
M
Z
Z
Z
Z
Z
Z
Z
Y
S
"}
(28,1,1) = {"
S
S
Y
Y
Y
Z
M
Z
M
Z
Z
Y
Y
Y
S
S
Y
Y
Y
Y
Z
Z
M
Z
Z
Z
Y
Y
S
"}
(29,1,1) = {"
S
S
S
Y
Y
Z
Z
Z
Z
Z
Y
Y
Y
S
S
S
S
Y
Y
Y
Y
Y
Y
Y
Y
Y
Y
S
S
"}
