//MAP CONVERTED BY dmm2tgm.py THIS HEADER COMMENT PREVENTS RECONVERSION, DO NOT REMOVE
"a" = (
/turf/closed/wall/mineral/titanium,
/area/shuttle/labor)
"b" = (
/obj/effect/spawner/structure/window/shuttle,
/turf/open/floor/plating,
/area/shuttle/labor)
"i" = (
/obj/machinery/door/airlock/titanium{
	name = "Labor Shuttle Airlock";
	req_access_txt = "2"
	},
/obj/effect/turf_decal/stripes/line{
	dir = 4
	},
/obj/effect/turf_decal/stripes/line{
	dir = 8
	},
/turf/open/floor/mineral/plastitanium,
/area/shuttle/labor)
"j" = (
/obj/machinery/door/airlock/titanium{
	name = "Labor Shuttle Airlock";
	req_access_txt = "2"
	},
/obj/effect/turf_decal/stripes/line,
/obj/effect/turf_decal/stripes/line{
	dir = 1
	},
/turf/open/floor/mineral/plastitanium,
/area/shuttle/labor)
"v" = (
/turf/closed/wall/mineral/titanium/nodiagonal,
/area/shuttle/labor)
"x" = (
/turf/closed/wall/mineral/plastitanium,
/area/shuttle/labor)
"z" = (
/obj/machinery/mineral/labor_claim_console{
	machinedir = 1;
	pixel_x = 30
	},
/obj/machinery/atmospherics/pipe/simple/supplymain/hidden,
/obj/machinery/mineral/labor_claim_console{
	machinedir = 1;
	pixel_x = 30
	},
/obj/effect/turf_decal/stripes/line{
	dir = 5
	},
/obj/effect/turf_decal/tile/neutral/opposingcorners,
/turf/open/floor/mineral/plastitanium/red,
/area/shuttle/labor)
"A" = (
/obj/machinery/computer/weapons,
/obj/effect/turf_decal/bot,
/turf/open/floor/mineral/plastitanium,
/area/shuttle/labor)
"B" = (
/obj/effect/turf_decal/stripes/line{
	dir = 8
	},
/obj/effect/turf_decal/stripes/corner{
	dir = 4
	},
/obj/effect/turf_decal/tile/neutral/opposingcorners,
/turf/open/floor/mineral/plastitanium/red,
/area/shuttle/labor)
"D" = (
/obj/machinery/mineral/stacking_machine/laborstacker{
	input_dir = 2;
	output_dir = 1
	},
/obj/effect/turf_decal/stripes/line{
	dir = 8
	},
/obj/effect/turf_decal/stripes/line{
	dir = 4
	},
/obj/machinery/atmospherics/pipe/simple/supplymain/hidden,
/turf/open/floor/mineral/plastitanium,
/area/shuttle/labor)
"E" = (
/obj/structure/chair/fancy/shuttle{
	dir = 4
	},
/obj/effect/turf_decal/stripes/line{
	dir = 10
	},
/obj/effect/turf_decal/tile/neutral/opposingcorners,
/turf/open/floor/mineral/plastitanium/red,
/area/shuttle/labor)
"F" = (
/obj/effect/turf_decal/stripes/line{
	dir = 9
	},
/obj/effect/turf_decal/stripes/corner,
/obj/effect/turf_decal/tile/neutral/opposingcorners,
/turf/open/floor/mineral/plastitanium/red,
/area/shuttle/labor)
"G" = (
/obj/machinery/door/airlock/titanium{
	id_tag = "prisonshuttle";
	name = "Labor Shuttle Airlock"
	},
/obj/docking_port/mobile{
	dir = 8;
	dwidth = 2;
	faction_type = /datum/faction/station;
	height = 5;
	id = "laborcamp";
	name = "labor camp shuttle";
	port_direction = 4;
	width = 9
	},
/obj/effect/turf_decal/stripes/line{
	dir = 4
	},
/obj/effect/turf_decal/stripes/line{
	dir = 8
	},
/turf/open/floor/mineral/plastitanium,
/area/shuttle/labor)
"I" = (
/obj/machinery/atmospherics/pipe/manifold/supplymain/hidden{
	dir = 4
	},
/obj/effect/turf_decal/stripes/line,
/obj/effect/turf_decal/tile/brown/opposingcorners,
/turf/open/floor/mineral/titanium/yellow,
/area/shuttle/labor)
"L" = (
/obj/machinery/shuttle_weapon/laser,
/turf/closed/wall/mineral/titanium,
/area/shuttle/labor)
"M" = (
/obj/effect/spawner/structure/window/shuttle,
/obj/machinery/atmospherics/components/unary/shuttle/engine_heater{
	dir = 1
	},
/turf/open/floor/plating,
/area/shuttle/labor)
"N" = (
/obj/machinery/light{
	dir = 1
	},
/obj/effect/turf_decal/stripes/line{
	dir = 1
	},
/obj/effect/turf_decal/tile/neutral/opposingcorners,
/turf/open/floor/mineral/plastitanium/red,
/area/shuttle/labor)
"O" = (
/obj/structure/reagent_dispensers/peppertank{
	pixel_x = -31
	},
/obj/effect/turf_decal/bot,
/obj/machinery/computer/shuttle_flight/labor,
/turf/open/floor/mineral/plastitanium,
/area/shuttle/labor)
"Q" = (
/obj/machinery/shuttle/engine/plasma{
	dir = 1
	},
/turf/open/floor/plating/airless,
/area/shuttle/labor)
"R" = (
/obj/effect/turf_decal/stripes/line,
/obj/effect/turf_decal/tile/neutral/opposingcorners,
/turf/open/floor/mineral/plastitanium/red,
/area/shuttle/labor)
"T" = (
/obj/machinery/button/flasher{
	id = "gulagshuttleflasher";
	name = "Flash Control";
	pixel_y = -26;
	req_access_txt = "1"
	},
/obj/machinery/light,
/obj/effect/turf_decal/stripes/line{
	dir = 1
	},
/obj/effect/turf_decal/stripes/line,
/obj/effect/turf_decal/tile/neutral/opposingcorners,
/turf/open/floor/mineral/plastitanium/red,
/area/shuttle/labor)
"U" = (
/obj/machinery/atmospherics/pipe/simple/supplymain/hidden,
/obj/machinery/mineral/stacking_unit_console{
	machinedir = 2;
	pixel_x = 30;
	pixel_y = 30
	},
/obj/effect/turf_decal/stripes/line{
	dir = 1
	},
/obj/effect/turf_decal/stripes/line,
/obj/effect/turf_decal/tile/neutral/opposingcorners,
/turf/open/floor/mineral/plastitanium/red,
/area/shuttle/labor)
"W" = (
/obj/machinery/atmospherics/pipe/simple/supplymain/hidden,
/obj/machinery/flasher{
	id = "gulagshuttleflasher";
	pixel_x = 25
	},
/obj/structure/chair/fancy/shuttle{
	dir = 8
	},
/obj/effect/turf_decal/stripes/line{
	dir = 6
	},
/obj/effect/turf_decal/tile/neutral/opposingcorners,
/turf/open/floor/mineral/plastitanium/red,
/area/shuttle/labor)
"X" = (
/obj/machinery/atmospherics/components/unary/portables_connector,
/obj/machinery/portable_atmospherics/canister/toxins,
/obj/item/wrench,
/turf/open/floor/mineral/plastitanium,
/area/shuttle/labor)
"Y" = (
/obj/effect/turf_decal/loading_area{
	dir = 4
	},
/obj/effect/turf_decal/stripes/line,
/obj/effect/turf_decal/tile/brown/opposingcorners,
/obj/machinery/atmospherics/pipe/manifold/supplymain/hidden{
	dir = 1
	},
/turf/open/floor/mineral/titanium/yellow,
/area/shuttle/labor)
"Z" = (
/obj/machinery/atmospherics/pipe/simple/supplymain/hidden{
	dir = 6
	},
/obj/structure/closet/crate,
/obj/effect/turf_decal/delivery,
/obj/effect/turf_decal/stripes/line,
/obj/effect/turf_decal/tile/brown/opposingcorners,
/turf/open/floor/mineral/titanium/yellow,
/area/shuttle/labor)

(1,1,1) = {"
L
a
b
a
b
a
b
v
x
"}
(2,1,1) = {"
b
O
F
j
B
E
Z
M
Q
"}
(3,1,1) = {"
b
A
T
a
N
R
Y
M
Q
"}
(4,1,1) = {"
b
X
U
D
z
W
I
M
Q
"}
(5,1,1) = {"
L
a
i
a
a
a
G
v
x
"}
