//MAP CONVERTED BY dmm2tgm.py THIS HEADER COMMENT PREVENTS RECONVERSION, DO NOT REMOVE
"a" = (
/obj/machinery/mineral/stacking_machine/laborstacker{
	input_dir = 2;
	output_dir = 1
	},
/obj/effect/turf_decal/stripes/line{
	dir = 8
	},
/turf/open/floor/mineral/plastitanium/red,
/area/shuttle/labor)
"b" = (
/obj/machinery/mineral/labor_claim_console{
	machinedir = 1;
	pixel_x = 30
	},
/obj/effect/turf_decal/stripes/corner{
	dir = 1
	},
/turf/open/floor/mineral/plastitanium/red,
/area/shuttle/labor)
"c" = (
/obj/structure/chair/fancy/shuttle{
	dir = 1
	},
/obj/effect/turf_decal/stripes/line,
/obj/structure/cable/yellow{
	icon_state = "2-8"
	},
/obj/structure/cable/yellow{
	icon_state = "4-8"
	},
/obj/structure/window/reinforced/spawner/west,
/turf/open/floor/mineral/plastitanium/red,
/area/shuttle/labor)
"g" = (
/obj/effect/turf_decal/stripes/corner{
	dir = 4
	},
/obj/machinery/power/terminal,
/obj/structure/cable/yellow,
/turf/open/floor/mineral/plastitanium/red,
/area/shuttle/labor)
"i" = (
/obj/machinery/door/airlock/titanium{
	name = "Labor Shuttle Airlock";
	req_access_txt = "2"
	},
/obj/effect/turf_decal/stripes/line{
	dir = 4
	},
/obj/structure/cable/yellow{
	icon_state = "1-2"
	},
/turf/open/floor/mineral/plastitanium/red,
/area/shuttle/labor)
"j" = (
/obj/machinery/button/flasher{
	id = "gulagshuttleflasher";
	name = "Flash Control";
	pixel_y = -26;
	req_access_txt = "1"
	},
/obj/effect/turf_decal/stripes/line{
	dir = 1
	},
/obj/effect/turf_decal/stripes/line,
/obj/machinery/light,
/obj/structure/cable/yellow{
	icon_state = "4-8"
	},
/obj/structure/chair/fancy/shuttle{
	dir = 1
	},
/turf/open/floor/mineral/plastitanium/red,
/area/shuttle/labor)
"k" = (
/obj/machinery/shuttle_weapon/laser,
/turf/closed/wall/mineral/titanium,
/area/shuttle/labor)
"l" = (
/obj/effect/turf_decal/caution/stand_clear{
	dir = 8
	},
/obj/effect/turf_decal/stripes/corner{
	dir = 8
	},
/obj/structure/cable/yellow{
	icon_state = "2-8"
	},
/turf/open/floor/mineral/plastitanium/red,
/area/shuttle/labor)
"m" = (
/obj/effect/turf_decal/delivery,
/obj/machinery/computer/weapons,
/turf/open/floor/mineral/plastitanium,
/area/shuttle/labor)
"o" = (
/obj/effect/turf_decal/caution/stand_clear{
	dir = 8
	},
/obj/structure/cable/yellow{
	icon_state = "2-4"
	},
/turf/open/floor/mineral/plastitanium,
/area/shuttle/labor)
"p" = (
/obj/effect/turf_decal/stripes/line{
	dir = 1
	},
/obj/machinery/light{
	dir = 1
	},
/turf/open/floor/mineral/plastitanium/red,
/area/shuttle/labor)
"y" = (
/turf/closed/wall/mineral/titanium,
/area/shuttle/labor)
"z" = (
/obj/machinery/mineral/stacking_unit_console{
	machinedir = 2;
	pixel_x = 30;
	pixel_y = -4
	},
/obj/effect/turf_decal/stripes/line{
	dir = 1
	},
/obj/effect/turf_decal/stripes/corner{
	dir = 8
	},
/obj/structure/cable/yellow{
	icon_state = "1-8"
	},
/turf/open/floor/mineral/plastitanium/red,
/area/shuttle/labor)
"B" = (
/obj/effect/spawner/structure/window/shuttle,
/turf/open/floor/plating,
/area/shuttle/labor)
"C" = (
/obj/machinery/shuttle/engine/ion{
	dir = 1
	},
/turf/open/floor/plating/airless,
/area/shuttle/labor)
"G" = (
/obj/machinery/flasher{
	id = "gulagshuttleflasher";
	pixel_x = -24
	},
/obj/effect/turf_decal/stripes/line,
/obj/machinery/power/smes{
	charge = 5e+006
	},
/obj/structure/cable/yellow{
	icon_state = "0-2"
	},
/obj/structure/cable/yellow{
	icon_state = "0-4"
	},
/obj/machinery/door/window/brigdoor{
	dir = 1;
	req_access_txt = "2"
	},
/turf/open/floor/mineral/plastitanium/red,
/area/shuttle/labor)
"H" = (
/turf/closed/wall/mineral/plastitanium,
/area/shuttle/labor)
"K" = (
/obj/effect/turf_decal/bot,
/obj/machinery/computer/shuttle_flight/labor,
/turf/open/floor/mineral/plastitanium,
/area/shuttle/labor)
"L" = (
/obj/structure/cable/yellow{
	icon_state = "0-8"
	},
/obj/machinery/door/airlock/titanium{
	name = "Labor Shuttle Airlock";
	req_access_txt = "2"
	},
/obj/structure/fans/tiny,
/turf/open/floor/mineral/titanium,
/area/shuttle/labor)
"M" = (
/obj/effect/spawner/structure/window/shuttle,
/obj/machinery/power/engine_capacitor_bank{
	dir = 1
	},
/obj/structure/cable/yellow,
/turf/open/floor/plating/airless,
/area/shuttle/labor)
"O" = (
/obj/structure/reagent_dispensers/peppertank{
	pixel_x = -31
	},
/obj/effect/turf_decal/stripes/line{
	dir = 1
	},
/obj/effect/turf_decal/stripes/corner,
/obj/structure/cable/yellow{
	icon_state = "2-4"
	},
/turf/open/floor/mineral/plastitanium/red,
/area/shuttle/labor)
"U" = (
/turf/closed/wall/mineral/titanium/nodiagonal,
/area/shuttle/labor)
"Z" = (
/obj/machinery/door/airlock/titanium{
	id_tag = "prisonshuttle";
	name = "Labor Shuttle Airlock"
	},
/obj/structure/fans/tiny,
/turf/open/floor/mineral/titanium,
/area/shuttle/labor)

(1,1,1) = {"
k
B
y
y
B
y
U
H
"}
(2,1,1) = {"
B
m
O
i
g
G
M
C
"}
(3,1,1) = {"
B
K
j
y
p
c
M
C
"}
(4,1,1) = {"
B
o
z
a
b
l
M
C
"}
(5,1,1) = {"
k
L
y
y
y
Z
U
H
"}
