//MAP CONVERTED BY dmm2tgm.py THIS HEADER COMMENT PREVENTS RECONVERSION, DO NOT REMOVE
"a" = (
/turf/closed/wall/mineral/titanium,
/area/shuttle/labor)
"b" = (
/obj/effect/spawner/structure/window/shuttle,
/turf/open/floor/plating,
/area/shuttle/labor)
"c" = (
/obj/machinery/computer/shuttle_flight/labor{
	dir = 4
	},
/obj/structure/reagent_dispensers/peppertank{
	pixel_x = -31
	},
/turf/open/floor/mineral/plastitanium/red,
/area/shuttle/labor)
"f" = (
/turf/open/floor/mineral/plastitanium/red,
/area/shuttle/labor)
"k" = (
/obj/machinery/mineral/stacking_machine/laborstacker{
	input_dir = 2;
	output_dir = 1
	},
/turf/open/floor/plasteel/dark,
/area/shuttle/labor)
"m" = (
/obj/machinery/light{
	dir = 1
	},
/turf/open/floor/mineral/titanium,
/area/shuttle/labor)
"u" = (
/obj/structure/closet/crate,
/obj/structure/cable/yellow{
	icon_state = "1-2"
	},
/obj/structure/cable/yellow{
	icon_state = "1-4"
	},
/turf/open/floor/mineral/titanium,
/area/shuttle/labor)
"x" = (
/obj/machinery/door/airlock/titanium{
	name = "Labor Shuttle Airlock";
	req_access_txt = "2"
	},
/obj/structure/cable/yellow{
	icon_state = "1-2"
	},
/turf/open/floor/mineral/plastitanium/red,
/area/shuttle/labor)
"A" = (
/obj/machinery/door/airlock/titanium{
	id_tag = "prisonshuttle";
	name = "Labor Shuttle Airlock"
	},
/obj/structure/fans/tiny,
/turf/open/floor/plating,
/area/shuttle/labor)
"B" = (
/obj/structure/window/reinforced{
	dir = 1;
	layer = 2.9
	},
/obj/machinery/power/engine_capacitor_bank{
	dir = 1
	},
/obj/structure/cable/yellow,
/turf/open/floor/plating/airless,
/area/shuttle/labor)
"G" = (
/obj/structure/cable/yellow{
	icon_state = "2-4"
	},
/turf/open/floor/mineral/plastitanium/red,
/area/shuttle/labor)
"I" = (
/obj/machinery/button/flasher{
	id = "gulagshuttleflasher";
	name = "Flash Control";
	pixel_y = -26;
	req_access_txt = "1"
	},
/obj/machinery/light,
/obj/structure/cable/yellow{
	icon_state = "0-8"
	},
/obj/machinery/power/smes{
	charge = 5e+006
	},
/turf/open/floor/mineral/plastitanium/red,
/area/shuttle/labor)
"L" = (
/obj/machinery/power/terminal{
	dir = 8
	},
/obj/structure/cable/yellow,
/obj/structure/table,
/obj/item/restraints/handcuffs,
/obj/item/folder/red,
/turf/open/floor/mineral/plastitanium/red,
/area/shuttle/labor)
"M" = (
/obj/structure/chair/fancy/shuttle{
	dir = 1
	},
/turf/open/floor/mineral/plastitanium/red,
/area/shuttle/labor)
"N" = (
/obj/machinery/shuttle_weapon/laser,
/turf/closed/wall/mineral/titanium,
/area/shuttle/labor)
"P" = (
/obj/machinery/shuttle/engine/ion{
	dir = 1
	},
/turf/open/floor/plating/airless,
/area/shuttle/labor)
"Q" = (
/obj/structure/cable/yellow{
	icon_state = "2-8"
	},
/turf/open/floor/mineral/titanium,
/area/shuttle/labor)
"R" = (
/obj/machinery/door/airlock/titanium{
	name = "Labor Shuttle Airlock";
	req_access_txt = "2"
	},
/obj/structure/cable/yellow{
	icon_state = "0-8"
	},
/obj/structure/fans/tiny,
/turf/open/floor/plating,
/area/shuttle/labor)
"S" = (
/obj/structure/cable/yellow{
	icon_state = "2-8"
	},
/obj/structure/cable/yellow{
	icon_state = "4-8"
	},
/turf/open/floor/mineral/titanium,
/area/shuttle/labor)
"U" = (
/obj/machinery/computer/weapons{
	dir = 8
	},
/turf/open/floor/mineral/plastitanium/red,
/area/shuttle/labor)
"X" = (
/obj/machinery/mineral/stacking_unit_console{
	machinedir = 2;
	pixel_x = 30;
	pixel_y = 30
	},
/obj/structure/cable/yellow{
	icon_state = "2-4"
	},
/turf/open/floor/mineral/plastitanium/red,
/area/shuttle/labor)
"Y" = (
/obj/structure/chair/fancy/shuttle{
	dir = 8
	},
/obj/machinery/mineral/labor_claim_console{
	machinedir = 1;
	pixel_x = 28;
	pixel_y = 28
	},
/obj/machinery/flasher{
	id = "gulagshuttleflasher";
	pixel_x = 25
	},
/turf/open/floor/mineral/titanium,
/area/shuttle/labor)
"Z" = (
/obj/structure/cable/yellow{
	icon_state = "1-2"
	},
/turf/open/floor/mineral/titanium,
/area/shuttle/labor)

(1,1,1) = {"
N
a
b
a
a
b
a
a
a
"}
(2,1,1) = {"
b
c
f
G
x
Z
u
B
P
"}
(3,1,1) = {"
b
M
f
I
a
m
S
B
P
"}
(4,1,1) = {"
b
U
X
L
k
Y
Q
B
P
"}
(5,1,1) = {"
N
a
R
a
a
a
A
a
a
"}
