//MAP CONVERTED BY dmm2tgm.py THIS HEADER COMMENT PREVENTS RECONVERSION, DO NOT REMOVE
"a" = (
/turf/closed/wall/mineral/titanium,
/area/shuttle/labor)
"b" = (
/obj/effect/spawner/structure/window/shuttle,
/turf/open/floor/plating,
/area/shuttle/labor)
"c" = (
/obj/machinery/computer/shuttle_flight/labor{
	dir = 4
	},
/obj/structure/reagent_dispensers/peppertank{
	pixel_x = -31
	},
/obj/effect/turf_decal/bot,
/turf/open/floor/mineral/plastitanium,
/area/shuttle/labor)
"d" = (
/obj/structure/chair/fancy/shuttle{
	dir = 1
	},
/turf/open/floor/mineral/plastitanium,
/area/shuttle/labor)
"k" = (
/obj/machinery/mineral/stacking_machine/laborstacker{
	input_dir = 2;
	output_dir = 1
	},
/obj/effect/turf_decal/stripes/line{
	dir = 8
	},
/obj/effect/turf_decal/stripes/line{
	dir = 4
	},
/turf/open/floor/mineral/plastitanium,
/area/shuttle/labor)
"l" = (
/obj/machinery/door/airlock/titanium{
	name = "Labor Shuttle Airlock";
	req_access_txt = "2"
	},
/obj/effect/turf_decal/stripes/line,
/obj/effect/turf_decal/stripes/line{
	dir = 1
	},
/obj/structure/cable/yellow{
	icon_state = "1-2"
	},
/turf/open/floor/mineral/plastitanium,
/area/shuttle/labor)
"n" = (
/obj/structure/cable/yellow{
	icon_state = "0-8"
	},
/obj/machinery/door/airlock/titanium{
	name = "Labor Shuttle Airlock";
	req_access_txt = "2"
	},
/obj/effect/turf_decal/stripes/line{
	dir = 4
	},
/obj/effect/turf_decal/stripes/line{
	dir = 8
	},
/obj/structure/fans/tiny,
/turf/open/floor/mineral/plastitanium,
/area/shuttle/labor)
"o" = (
/obj/machinery/computer/weapons{
	dir = 8
	},
/turf/open/floor/mineral/plastitanium,
/area/shuttle/labor)
"p" = (
/obj/effect/turf_decal/loading_area{
	dir = 4
	},
/obj/effect/turf_decal/stripes/line,
/obj/effect/turf_decal/tile/brown/opposingcorners,
/obj/structure/cable/yellow{
	icon_state = "2-8"
	},
/obj/structure/cable/yellow{
	icon_state = "4-8"
	},
/obj/structure/window/reinforced/spawner/west,
/turf/open/floor/mineral/titanium/yellow,
/area/shuttle/labor)
"r" = (
/obj/machinery/door/airlock/titanium{
	id_tag = "prisonshuttle";
	name = "Labor Shuttle Airlock"
	},
/obj/docking_port/mobile{
	dir = 8;
	dwidth = 2;
	height = 5;
	id = "laborcamp";
	name = "labor camp shuttle";
	port_direction = 4;
	width = 9
	},
/obj/effect/turf_decal/stripes/line{
	dir = 4
	},
/obj/effect/turf_decal/stripes/line{
	dir = 8
	},
/obj/structure/fans/tiny,
/turf/open/floor/mineral/plastitanium,
/area/shuttle/labor)
"s" = (
/obj/effect/turf_decal/stripes/line{
	dir = 8
	},
/obj/effect/turf_decal/stripes/corner{
	dir = 4
	},
/obj/effect/turf_decal/tile/neutral/opposingcorners,
/obj/structure/cable/yellow{
	icon_state = "1-2"
	},
/turf/open/floor/mineral/plastitanium/red,
/area/shuttle/labor)
"v" = (
/turf/closed/wall/mineral/titanium/nodiagonal,
/area/shuttle/labor)
"x" = (
/turf/closed/wall/mineral/plastitanium,
/area/shuttle/labor)
"z" = (
/obj/machinery/button/flasher{
	id = "gulagshuttleflasher";
	name = "Flash Control";
	pixel_y = -26;
	req_access_txt = "1"
	},
/obj/machinery/light,
/obj/effect/turf_decal/stripes/line{
	dir = 1
	},
/obj/effect/turf_decal/stripes/line,
/obj/effect/turf_decal/tile/neutral/opposingcorners,
/obj/structure/cable/yellow{
	icon_state = "4-8"
	},
/turf/open/floor/mineral/plastitanium/red,
/area/shuttle/labor)
"A" = (
/obj/machinery/mineral/stacking_unit_console{
	machinedir = 2;
	pixel_x = 30;
	pixel_y = 30
	},
/obj/effect/turf_decal/stripes/line{
	dir = 1
	},
/obj/effect/turf_decal/stripes/line,
/obj/effect/turf_decal/tile/neutral/opposingcorners,
/obj/structure/cable/yellow{
	icon_state = "4-8"
	},
/turf/open/floor/mineral/plastitanium/red,
/area/shuttle/labor)
"E" = (
/obj/effect/turf_decal/stripes/line{
	dir = 9
	},
/obj/effect/turf_decal/stripes/corner,
/obj/effect/turf_decal/tile/neutral/opposingcorners,
/obj/structure/cable/yellow{
	icon_state = "2-4"
	},
/turf/open/floor/mineral/plastitanium/red,
/area/shuttle/labor)
"H" = (
/obj/effect/turf_decal/delivery,
/obj/effect/turf_decal/stripes/line,
/obj/effect/turf_decal/tile/brown/opposingcorners,
/obj/structure/cable/yellow{
	icon_state = "0-2"
	},
/obj/structure/cable/yellow{
	icon_state = "0-4"
	},
/obj/machinery/power/smes{
	charge = 5e+006
	},
/obj/machinery/door/window/brigdoor{
	dir = 1;
	req_access_txt = "2"
	},
/turf/open/floor/mineral/titanium/yellow,
/area/shuttle/labor)
"I" = (
/obj/structure/chair/fancy/shuttle{
	dir = 4
	},
/obj/effect/turf_decal/stripes/line{
	dir = 10
	},
/obj/effect/turf_decal/tile/neutral/opposingcorners,
/obj/machinery/power/terminal,
/obj/structure/cable/yellow,
/turf/open/floor/mineral/plastitanium/red,
/area/shuttle/labor)
"J" = (
/obj/machinery/flasher{
	id = "gulagshuttleflasher";
	pixel_x = 25
	},
/obj/structure/chair/fancy/shuttle{
	dir = 8
	},
/obj/effect/turf_decal/stripes/line{
	dir = 6
	},
/obj/effect/turf_decal/tile/neutral/opposingcorners,
/turf/open/floor/mineral/plastitanium/red,
/area/shuttle/labor)
"O" = (
/obj/effect/turf_decal/stripes/line,
/obj/effect/turf_decal/tile/neutral/opposingcorners,
/turf/open/floor/mineral/plastitanium/red,
/area/shuttle/labor)
"R" = (
/obj/machinery/mineral/labor_claim_console{
	machinedir = 1;
	pixel_x = 30
	},
/obj/effect/turf_decal/stripes/line{
	dir = 5
	},
/obj/effect/turf_decal/tile/neutral/opposingcorners,
/turf/open/floor/mineral/plastitanium/red,
/area/shuttle/labor)
"S" = (
/obj/machinery/shuttle_weapon/laser,
/turf/closed/wall/mineral/titanium,
/area/shuttle/labor)
"U" = (
/obj/machinery/light{
	dir = 1
	},
/obj/effect/turf_decal/stripes/line{
	dir = 1
	},
/obj/effect/turf_decal/tile/neutral/opposingcorners,
/turf/open/floor/mineral/plastitanium/red,
/area/shuttle/labor)
"V" = (
/obj/machinery/shuttle/engine/ion{
	dir = 1
	},
/turf/open/floor/plating/airless,
/area/shuttle/labor)
"W" = (
/obj/effect/spawner/structure/window/shuttle,
/obj/machinery/power/engine_capacitor_bank{
	dir = 1
	},
/obj/structure/cable/yellow,
/turf/open/floor/plating,
/area/shuttle/labor)
"Z" = (
/obj/effect/turf_decal/stripes/line,
/obj/effect/turf_decal/tile/brown/opposingcorners,
/obj/structure/cable/yellow{
	icon_state = "2-8"
	},
/turf/open/floor/mineral/titanium/yellow,
/area/shuttle/labor)

(1,1,1) = {"
S
a
b
a
b
a
b
v
x
"}
(2,1,1) = {"
b
c
E
l
s
I
H
W
V
"}
(3,1,1) = {"
b
d
z
a
U
O
p
W
V
"}
(4,1,1) = {"
b
o
A
k
R
J
Z
W
V
"}
(5,1,1) = {"
S
a
n
a
a
a
r
v
x
"}
