//MAP CONVERTED BY dmm2tgm.py THIS HEADER COMMENT PREVENTS RECONVERSION, DO NOT REMOVE
"ad" = (
/turf/open/floor/plasteel,
/area/ruin_mapping/hallway)
"aW" = (
/turf/template_noop,
/area/template_noop)
"cK" = (
/obj/machinery/biogenerator,
/obj/effect/decal/cleanable/dirt,
/turf/open/floor/plasteel,
/area/ruin_mapping/nullroom)
"dn" = (
/obj/effect/decal/cleanable/dirt,
/obj/machinery/vending/cola/random,
/turf/open/floor/plasteel,
/area/ruin_mapping/nullroom)
"dQ" = (
/obj/machinery/computer/libraryconsole/bookmanagement,
/obj/structure/table,
/obj/effect/decal/cleanable/dirt,
/turf/open/floor/plasteel,
/area/ruin_mapping/nullroom)
"fZ" = (
/obj/machinery/door/airlock{
	name = "Unisex Restroom"
	},
/turf/open/floor/plasteel/freezer,
/area/ruin_mapping/nullroom)
"hq" = (
/obj/structure/table,
/obj/item/pen,
/obj/effect/spawner/lootdrop/ruinloot/security,
/turf/open/floor/plasteel,
/area/ruin_mapping/nullroom)
"hu" = (
/obj/effect/turf_decal/tile/blue/opposingcorners{
	dir = 1
	},
/turf/open/floor/plasteel/cafeteria,
/area/ruin_mapping/nullroom)
"hU" = (
/obj/structure/bookcase,
/obj/effect/decal/cleanable/dirt,
/turf/open/floor/plasteel,
/area/ruin_mapping/nullroom)
"jj" = (
/obj/structure/window/reinforced,
/obj/machinery/hydroponics/soil,
/obj/item/cultivator,
/obj/effect/turf_decal/tile/green/anticorner/contrasted,
/turf/open/floor/plasteel,
/area/ruin_mapping/nullroom)
"jn" = (
/obj/machinery/washing_machine,
/obj/structure/window/reinforced{
	dir = 1
	},
/obj/effect/turf_decal/tile/blue/opposingcorners{
	dir = 1
	},
/turf/open/floor/plasteel/cafeteria,
/area/ruin_mapping/nullroom)
"jz" = (
/turf/open/floor/plating,
/area/ruin_mapping/nullroom)
"kJ" = (
/obj/machinery/seed_extractor,
/obj/effect/decal/cleanable/dirt,
/turf/open/floor/plasteel,
/area/ruin_mapping/nullroom)
"lv" = (
/turf/closed/wall,
/area/ruin_mapping/nullroom)
"lG" = (
/obj/structure/toilet{
	dir = 1
	},
/turf/open/floor/plasteel/freezer,
/area/ruin_mapping/nullroom)
"lI" = (
/obj/machinery/door/airlock/public/glass{
	id_tag = "permabolt2";
	name = "Cell 2"
	},
/obj/effect/mapping_helpers/airlock/cyclelink_helper,
/obj/effect/decal/cleanable/dirt,
/turf/open/floor/plasteel,
/area/ruin_mapping/nullroom)
"mv" = (
/obj/structure/sign/warning/electricshock{
	pixel_y = 32
	},
/obj/machinery/hydroponics/soil,
/obj/item/plant_analyzer,
/obj/machinery/camera/autoname,
/obj/effect/turf_decal/tile/green/anticorner/contrasted{
	dir = 4
	},
/turf/open/floor/plasteel,
/area/ruin_mapping/nullroom)
"mW" = (
/obj/structure/window/reinforced,
/obj/effect/turf_decal/tile/blue/opposingcorners{
	dir = 1
	},
/turf/open/floor/plasteel/cafeteria,
/area/ruin_mapping/nullroom)
"pC" = (
/obj/structure/table,
/obj/item/storage/pill_bottle/dice,
/turf/open/floor/plasteel,
/area/ruin_mapping/nullroom)
"pO" = (
/obj/machinery/door/airlock/security/glass{
	name = "Long-Term Cell 1";
	req_access_txt = "2"
	},
/obj/structure/cable/yellow{
	icon_state = "1-2"
	},
/obj/effect/mapping_helpers/airlock/cyclelink_helper{
	dir = 1
	},
/obj/effect/decal/cleanable/dirt,
/turf/open/floor/plasteel,
/area/ruin_mapping/nullroom)
"rp" = (
/obj/machinery/door/airlock/public/glass{
	id_tag = "permabolt3";
	name = "Cell 3"
	},
/obj/effect/mapping_helpers/airlock/cyclelink_helper,
/obj/effect/decal/cleanable/dirt,
/turf/open/floor/plasteel,
/area/ruin_mapping/nullroom)
"si" = (
/obj/structure/table,
/obj/structure/bedsheetbin,
/obj/effect/turf_decal/tile/blue/opposingcorners{
	dir = 1
	},
/turf/open/floor/plasteel/cafeteria,
/area/ruin_mapping/nullroom)
"su" = (
/obj/structure/window/reinforced,
/obj/machinery/hydroponics/soil,
/obj/item/cultivator,
/obj/effect/turf_decal/tile/green/half/contrasted{
	dir = 8
	},
/turf/open/floor/plasteel,
/area/ruin_mapping/nullroom)
"ve" = (
/obj/effect/decal/cleanable/dirt,
/obj/machinery/door/window/westleft{
	base_state = "right";
	icon_state = "right";
	name = "Unisex Showers"
	},
/turf/open/floor/plasteel/freezer,
/area/ruin_mapping/nullroom)
"vM" = (
/obj/structure/table,
/obj/item/paper,
/obj/item/pen,
/obj/effect/decal/cleanable/dirt,
/turf/open/floor/plasteel,
/area/ruin_mapping/nullroom)
"vY" = (
/obj/structure/window/reinforced,
/turf/open/floor/plating,
/area/ruin_mapping/nullroom)
"xe" = (
/obj/structure/window/reinforced,
/obj/machinery/hydroponics/soil,
/obj/item/seeds/potato,
/obj/effect/turf_decal/tile/green/anticorner/contrasted{
	dir = 8
	},
/turf/open/floor/plasteel,
/area/ruin_mapping/nullroom)
"xh" = (
/turf/open/floor/plasteel/freezer,
/area/ruin_mapping/nullroom)
"xP" = (
/obj/structure/window/reinforced,
/obj/machinery/hydroponics/soil,
/obj/item/seeds/grass,
/obj/effect/turf_decal/tile/green/half/contrasted{
	dir = 8
	},
/turf/open/floor/plasteel,
/area/ruin_mapping/nullroom)
"xS" = (
/obj/machinery/shower{
	dir = 8
	},
/obj/item/soap/nanotrasen,
/turf/open/floor/plasteel/freezer,
/area/ruin_mapping/nullroom)
"xV" = (
/obj/effect/abstract/open_area_marker{
	dir = 8
	},
/turf/open/floor/plasteel,
/area/ruin_mapping/hallway)
"zd" = (
/obj/effect/decal/cleanable/dirt,
/obj/structure/window/reinforced{
	dir = 8
	},
/turf/open/floor/plasteel/freezer,
/area/ruin_mapping/nullroom)
"zp" = (
/obj/machinery/hydroponics/soil,
/obj/item/seeds/carrot,
/obj/effect/turf_decal/tile/green/half/contrasted{
	dir = 4
	},
/turf/open/floor/plasteel,
/area/ruin_mapping/nullroom)
"zq" = (
/obj/structure/table,
/obj/item/toy/cards/deck,
/turf/open/floor/plasteel,
/area/ruin_mapping/nullroom)
"AG" = (
/obj/effect/abstract/open_area_marker{
	dir = 4
	},
/turf/open/floor/plasteel,
/area/ruin_mapping/hallway)
"AM" = (
/obj/structure/sink{
	pixel_y = 20
	},
/turf/open/floor/plating,
/area/ruin_mapping/nullroom)
"Be" = (
/obj/effect/abstract/doorway_marker,
/turf/open/floor/plasteel,
/area/ruin_mapping/nullroom)
"CC" = (
/obj/machinery/door/airlock/public/glass{
	id_tag = "permabolt1";
	name = "Cell 1"
	},
/obj/effect/mapping_helpers/airlock/cyclelink_helper,
/obj/effect/decal/cleanable/dirt,
/turf/open/floor/plasteel,
/area/ruin_mapping/nullroom)
"CE" = (
/obj/structure/table,
/obj/item/paper_bin{
	pixel_x = -3;
	pixel_y = 7
	},
/obj/item/pen,
/turf/open/floor/plasteel,
/area/ruin_mapping/nullroom)
"Ez" = (
/obj/structure/bed,
/obj/effect/decal/cleanable/dirt,
/turf/open/floor/plasteel,
/area/ruin_mapping/nullroom)
"EW" = (
/turf/closed/wall/r_wall,
/area/ruin_mapping/nullroom)
"Fz" = (
/obj/effect/decal/cleanable/dirt,
/obj/structure/table,
/obj/item/paper,
/obj/item/pen,
/turf/open/floor/plasteel,
/area/ruin_mapping/nullroom)
"Gr" = (
/obj/structure/window/reinforced{
	dir = 1
	},
/obj/effect/turf_decal/tile/blue/opposingcorners{
	dir = 1
	},
/turf/open/floor/plasteel/cafeteria,
/area/ruin_mapping/nullroom)
"Ha" = (
/obj/machinery/light,
/obj/effect/decal/cleanable/dirt,
/obj/machinery/vending/sustenance,
/turf/open/floor/plasteel,
/area/ruin_mapping/nullroom)
"KP" = (
/obj/machinery/hydroponics/soil,
/obj/item/seeds/ambrosia,
/obj/effect/turf_decal/tile/green/anticorner/contrasted{
	dir = 1
	},
/turf/open/floor/plasteel,
/area/ruin_mapping/nullroom)
"Le" = (
/obj/effect/decal/cleanable/dirt,
/obj/machinery/computer/arcade,
/turf/open/floor/plasteel,
/area/ruin_mapping/nullroom)
"My" = (
/obj/effect/spawner/structure/window/reinforced,
/obj/machinery/door/firedoor/window,
/turf/open/floor/plating,
/area/ruin_mapping/nullroom)
"Nf" = (
/obj/machinery/light{
	dir = 8
	},
/turf/open/floor/plating,
/area/ruin_mapping/nullroom)
"NR" = (
/obj/effect/decal/cleanable/dirt,
/turf/open/floor/plasteel,
/area/ruin_mapping/nullroom)
"NZ" = (
/obj/machinery/door/airlock/security/glass{
	name = "Long-Term Cell 2";
	req_access_txt = "2"
	},
/obj/effect/mapping_helpers/airlock/cyclelink_helper{
	dir = 1
	},
/obj/effect/decal/cleanable/dirt,
/turf/open/floor/plasteel,
/area/ruin_mapping/nullroom)
"Oe" = (
/obj/structure/lattice,
/turf/template_noop,
/area/template_noop)
"PN" = (
/obj/effect/decal/cleanable/dirt,
/obj/structure/bed,
/turf/open/floor/plasteel,
/area/ruin_mapping/nullroom)
"Qh" = (
/obj/structure/sink{
	dir = 8;
	pixel_x = -12;
	pixel_y = 2
	},
/turf/open/floor/plasteel/freezer,
/area/ruin_mapping/nullroom)
"Ra" = (
/obj/machinery/washing_machine,
/obj/structure/window/reinforced,
/obj/effect/turf_decal/tile/blue/opposingcorners{
	dir = 1
	},
/turf/open/floor/plasteel/cafeteria,
/area/ruin_mapping/nullroom)
"RC" = (
/obj/structure/chair/stool,
/obj/effect/decal/cleanable/dirt,
/turf/open/floor/plasteel,
/area/ruin_mapping/nullroom)
"SO" = (
/obj/structure/bed,
/obj/effect/decal/cleanable/dirt,
/obj/item/toy/plush/carpplushie,
/turf/open/floor/plasteel,
/area/ruin_mapping/nullroom)
"SX" = (
/obj/item/reagent_containers/glass/bucket,
/turf/open/floor/plating,
/area/ruin_mapping/nullroom)
"TT" = (
/obj/effect/decal/cleanable/dirt,
/turf/closed/wall/r_wall,
/area/ruin_mapping/nullroom)
"UG" = (
/mob/living/simple_animal/mouse/brown/Tom,
/turf/open/floor/plating,
/area/ruin_mapping/nullroom)
"VE" = (
/obj/machinery/door/airlock/security/glass{
	name = "Long-Term Cell 3";
	req_access_txt = "2"
	},
/obj/effect/mapping_helpers/airlock/cyclelink_helper{
	dir = 1
	},
/obj/effect/decal/cleanable/dirt,
/turf/open/floor/plasteel,
/area/ruin_mapping/nullroom)
"VL" = (
/obj/machinery/holopad,
/obj/effect/decal/cleanable/dirt,
/turf/open/floor/plasteel,
/area/ruin_mapping/nullroom)
"Wj" = (
/obj/machinery/hydroponics/soil,
/obj/item/seeds/glowshroom,
/obj/effect/turf_decal/tile/green/half/contrasted{
	dir = 4
	},
/turf/open/floor/plasteel,
/area/ruin_mapping/nullroom)
"ZT" = (
/obj/effect/decal/cleanable/dirt,
/turf/closed/wall,
/area/ruin_mapping/nullroom)

(1,1,1) = {"
Oe
Oe
Oe
EW
EW
EW
TT
TT
TT
EW
TT
TT
lv
ad
xV
ad
lv
"}
(2,1,1) = {"
EW
EW
EW
EW
hU
dQ
NR
NR
NR
rp
NR
NR
VE
ad
ad
ad
lv
"}
(3,1,1) = {"
EW
KP
Nf
xe
NR
RC
NR
VL
dn
lv
PN
vM
lv
ad
ad
ad
Be
"}
(4,1,1) = {"
My
zp
jz
xP
NR
NR
NR
NR
Ha
lv
lv
lv
lv
ad
ad
ad
lv
"}
(5,1,1) = {"
EW
jz
UG
vY
NR
NR
RC
NR
NR
lv
Ez
NR
lv
ad
ad
ad
lv
"}
(6,1,1) = {"
My
Wj
jz
su
NR
pC
zq
NR
NR
lI
NR
NR
NZ
ad
ad
ad
lv
"}
(7,1,1) = {"
EW
mv
jz
jj
RC
hq
CE
NR
NR
lv
RC
vM
lv
ad
ad
ad
Be
"}
(8,1,1) = {"
My
NR
jz
NR
NR
RC
NR
NR
NR
lv
lv
lv
lv
ad
ad
ad
lv
"}
(9,1,1) = {"
EW
AM
SX
NR
NR
NR
NR
NR
NR
lv
SO
Fz
lv
ad
ad
ad
lv
"}
(10,1,1) = {"
My
NR
NR
NR
Gr
hu
mW
Le
NR
CC
NR
NR
pO
ad
ad
ad
lv
"}
(11,1,1) = {"
EW
cK
kJ
NR
jn
si
Ra
zd
ve
lv
ZT
ZT
lv
ad
ad
ad
Be
"}
(12,1,1) = {"
EW
EW
EW
EW
EW
EW
EW
xS
xh
fZ
Qh
lG
lv
ad
ad
ad
lv
"}
(13,1,1) = {"
aW
aW
Oe
Oe
aW
Oe
EW
EW
EW
EW
EW
EW
EW
ad
AG
ad
lv
"}
