//MAP CONVERTED BY dmm2tgm.py THIS HEADER COMMENT PREVENTS RECONVERSION, DO NOT REMOVE
"aW" = (
/turf/open/floor/plasteel/white,
/area/ruin_mapping/nullroom)
"aY" = (
/obj/effect/mob_spawn/human/oldsec{
	dir = 4
	},
/turf/open/floor/plasteel/showroomfloor,
/area/ruin_mapping/nullroom)
"bb" = (
/obj/structure/showcase/machinery/tv,
/obj/structure/table/wood,
/obj/structure/window/spawner,
/turf/open/floor/wood,
/area/ruin_mapping/nullroom)
"bs" = (
/obj/structure/showcase/machinery/microwave,
/obj/structure/table/wood,
/obj/structure/window/spawner,
/turf/open/floor/wood,
/area/ruin_mapping/nullroom)
"cr" = (
/obj/structure/sign/departments/minsky/medical/chemistry/chemical2{
	pixel_x = -32
	},
/turf/open/floor/plasteel,
/area/ruin_mapping/hallway)
"cF" = (
/obj/machinery/door/airlock/public/glass{
	name = "Cryogenics"
	},
/obj/effect/turf_decal/stripes/line,
/turf/open/floor/plasteel/showroomfloor,
/area/ruin_mapping/nullroom)
"cR" = (
/obj/machinery/anesthetic_machine,
/obj/effect/turf_decal/tile/blue/half/contrasted{
	dir = 8
	},
/turf/open/floor/plasteel/white,
/area/ruin_mapping/nullroom)
"db" = (
/obj/structure/table,
/obj/item/storage/backpack/duffelbag/med/surgery,
/obj/effect/turf_decal/tile/blue/half/contrasted{
	dir = 4
	},
/turf/open/floor/plasteel/white,
/area/ruin_mapping/nullroom)
"de" = (
/turf/open/floor/plasteel/airless,
/area/ruin_mapping/hallway)
"dS" = (
/obj/machinery/door/airlock/research{
	name = "Robotics"
	},
/turf/open/floor/plasteel/white,
/area/ruin_mapping/nullroom)
"eh" = (
/obj/structure/table/glass/plasma,
/obj/item/storage/box/firingpins{
	pixel_y = 9
	},
/obj/item/stack/sheet/mineral/silver/five,
/obj/item/stack/sheet/mineral/gold/five{
	pixel_x = 7;
	pixel_y = -2
	},
/obj/item/reagent_containers/food/drinks/soda_cans/cola{
	pixel_x = -7
	},
/turf/open/floor/plasteel/white,
/area/ruin_mapping/nullroom)
"ft" = (
/turf/open/floor/plasteel/white/side{
	dir = 5
	},
/area/ruin_mapping/nullroom)
"fF" = (
/obj/machinery/door/airlock/research/glass{
	name = "Research Division"
	},
/turf/open/floor/plasteel/white/side{
	dir = 4
	},
/area/ruin_mapping/nullroom)
"gv" = (
/obj/effect/abstract/open_area_marker{
	dir = 4
	},
/turf/open/floor/plasteel/airless,
/area/ruin_mapping/hallway)
"gZ" = (
/obj/item/stack/cable_coil,
/obj/item/stock_parts/micro_laser,
/obj/item/circuitboard/machine/ore_silo,
/obj/structure/table/glass/plasma,
/obj/effect/turf_decal/tile/purple{
	dir = 4
	},
/turf/open/floor/plasteel/white,
/area/ruin_mapping/nullroom)
"hi" = (
/obj/machinery/door/airlock/medical{
	name = "Surgical Theatre"
	},
/turf/open/floor/plasteel/white,
/area/ruin_mapping/nullroom)
"hp" = (
/obj/machinery/cryopod,
/turf/open/floor/plasteel/showroomfloor,
/area/ruin_mapping/nullroom)
"hq" = (
/obj/effect/spawner/lootdrop/ruinloot/basic,
/turf/open/floor/plasteel,
/area/ruin_mapping/hallway)
"hQ" = (
/obj/item/gun/energy/kinetic_accelerator,
/obj/structure/rack,
/obj/effect/turf_decal/tile/purple,
/turf/open/floor/plasteel/white,
/area/ruin_mapping/nullroom)
"iZ" = (
/obj/machinery/stasis,
/obj/effect/turf_decal/tile/blue/half/contrasted{
	dir = 4
	},
/turf/open/floor/plasteel/white,
/area/ruin_mapping/nullroom)
"jR" = (
/obj/machinery/door/airlock/command/glass{
	name = "Corporate Showroom"
	},
/turf/open/floor/plasteel,
/area/ruin_mapping/nullroom)
"jW" = (
/turf/open/floor/plasteel/white/side{
	dir = 4
	},
/area/ruin_mapping/nullroom)
"lf" = (
/turf/closed/wall,
/area/ruin_mapping/nullroom)
"lm" = (
/obj/effect/decal/cleanable/dirt,
/obj/effect/mob_spawn/human/oldeng{
	dir = 4
	},
/turf/open/floor/plasteel/showroomfloor,
/area/ruin_mapping/nullroom)
"lV" = (
/obj/machinery/door/airlock/research/glass{
	name = "Research Division"
	},
/turf/open/floor/plasteel/white/side{
	dir = 1
	},
/area/ruin_mapping/nullroom)
"lZ" = (
/turf/open/floor/plasteel/white/side{
	dir = 6
	},
/area/ruin_mapping/nullroom)
"mj" = (
/obj/effect/spawner/lootdrop/glowstick/lit,
/turf/open/floor/plasteel/white,
/area/ruin_mapping/nullroom)
"mn" = (
/obj/machinery/door/firedoor,
/obj/machinery/smartfridge/chemistry/preloaded,
/turf/open/floor/plating,
/area/ruin_mapping/nullroom)
"mN" = (
/obj/structure/chair/office/light,
/obj/effect/turf_decal/tile/purple/anticorner/contrasted{
	dir = 8
	},
/turf/open/floor/plasteel/white,
/area/ruin_mapping/nullroom)
"mW" = (
/obj/structure/closet/crate,
/obj/item/storage/backpack/old,
/obj/item/storage/backpack/old,
/obj/item/crowbar,
/obj/effect/spawner/lootdrop/ruinloot/science,
/turf/open/floor/plasteel/white,
/area/ruin_mapping/nullroom)
"na" = (
/obj/structure/chair/office/light,
/turf/open/floor/plasteel/white,
/area/ruin_mapping/nullroom)
"nX" = (
/obj/effect/turf_decal/tile/purple,
/turf/open/floor/plasteel/white,
/area/ruin_mapping/nullroom)
"of" = (
/obj/effect/turf_decal/stripes/line{
	dir = 9
	},
/obj/machinery/rnd/production/protolathe,
/turf/open/floor/plasteel/freezer,
/area/ruin_mapping/nullroom)
"po" = (
/obj/effect/turf_decal/stripes/line{
	dir = 1
	},
/turf/open/floor/plasteel/freezer,
/area/ruin_mapping/nullroom)
"rj" = (
/obj/machinery/door/airlock/medical/glass{
	name = "Chemistry"
	},
/turf/open/floor/plasteel/white/side{
	dir = 8
	},
/area/ruin_mapping/nullroom)
"sO" = (
/obj/machinery/chem_master,
/obj/effect/turf_decal/tile/blue/half/contrasted{
	dir = 8
	},
/turf/open/floor/plasteel/white,
/area/ruin_mapping/nullroom)
"td" = (
/obj/item/stock_parts/matter_bin{
	pixel_y = 4
	},
/obj/item/stock_parts/capacitor{
	pixel_y = 6
	},
/obj/item/storage/toolbox/mechanical,
/obj/item/multitool,
/obj/structure/table/glass/plasma,
/obj/effect/turf_decal/tile/purple{
	dir = 4
	},
/turf/open/floor/plasteel/white,
/area/ruin_mapping/nullroom)
"te" = (
/obj/effect/turf_decal/tile/purple{
	dir = 4
	},
/turf/open/floor/plasteel,
/area/ruin_mapping/hallway)
"tt" = (
/obj/effect/turf_decal/tile/purple/anticorner/contrasted,
/turf/open/floor/plasteel/white,
/area/ruin_mapping/nullroom)
"uh" = (
/turf/open/floor/plasteel/dark/side{
	dir = 8
	},
/area/ruin_mapping/nullroom)
"uO" = (
/obj/structure/table/glass/plasma,
/obj/item/stack/sheet/mineral/diamond/five{
	pixel_y = 4
	},
/obj/item/stack/sheet/mineral/uranium/twenty,
/turf/open/floor/plasteel/white,
/area/ruin_mapping/nullroom)
"ww" = (
/obj/effect/decal/cleanable/blood,
/obj/effect/decal/cleanable/dirt,
/obj/machinery/computer/cryopod{
	pixel_y = 28
	},
/turf/open/floor/plasteel/showroomfloor,
/area/ruin_mapping/nullroom)
"wJ" = (
/obj/structure/rack,
/obj/item/clothing/suit/armor/vest/old{
	pixel_x = -1;
	pixel_y = 4
	},
/obj/item/clothing/head/helmet/old{
	pixel_x = 2;
	pixel_y = -2
	},
/obj/structure/window/spawner/north,
/turf/open/floor/wood,
/area/ruin_mapping/nullroom)
"wX" = (
/turf/open/floor/plasteel/dark/side{
	dir = 9
	},
/area/ruin_mapping/nullroom)
"xZ" = (
/obj/effect/spawner/lootdrop/glowstick/lit,
/obj/structure/sign/departments/minsky/research/robotics{
	pixel_y = 32
	},
/turf/open/floor/plasteel/airless,
/area/ruin_mapping/hallway)
"zf" = (
/obj/machinery/shower{
	dir = 4
	},
/turf/open/floor/noslip/white,
/area/ruin_mapping/nullroom)
"zy" = (
/obj/item/clothing/gloves/color/fyellow/old,
/obj/structure/rack,
/obj/structure/window/spawner/north,
/turf/open/floor/wood,
/area/ruin_mapping/nullroom)
"BO" = (
/obj/structure/sign/departments/minsky/research/research{
	pixel_y = 32
	},
/turf/open/floor/plasteel,
/area/ruin_mapping/hallway)
"Cq" = (
/obj/item/flashlight/glowstick,
/obj/item/flashlight/glowstick,
/obj/item/shuttle_creator,
/obj/structure/closet/crate/engineering,
/obj/item/storage/toolbox/syndicate,
/turf/open/floor/plasteel/white,
/area/ruin_mapping/nullroom)
"Cv" = (
/obj/machinery/rnd/production/circuit_imprinter,
/obj/effect/turf_decal/stripes/line{
	dir = 10
	},
/turf/open/floor/plasteel/freezer,
/area/ruin_mapping/nullroom)
"Dy" = (
/obj/effect/spawner/structure/window/reinforced/tinted,
/turf/open/floor/plating,
/area/ruin_mapping/nullroom)
"Fe" = (
/obj/structure/frame/machine,
/obj/item/stack/cable_coil/random/five,
/turf/open/floor/plasteel/white,
/area/ruin_mapping/nullroom)
"Ff" = (
/obj/structure/rack,
/obj/item/gun/energy/e_gun/old,
/obj/structure/window/spawner/north,
/turf/open/floor/wood,
/area/ruin_mapping/nullroom)
"Fq" = (
/obj/effect/turf_decal/stripes/line,
/turf/open/floor/plasteel/freezer,
/area/ruin_mapping/nullroom)
"Gu" = (
/obj/effect/spawner/structure/window/reinforced,
/turf/open/floor/plating,
/area/ruin_mapping/nullroom)
"Gw" = (
/obj/structure/table,
/obj/item/tank/internals/anesthetic,
/obj/item/clothing/mask/breath/medical,
/obj/effect/turf_decal/tile/blue/half/contrasted{
	dir = 8
	},
/turf/open/floor/plasteel/white,
/area/ruin_mapping/nullroom)
"Gz" = (
/obj/effect/turf_decal/tile/blue{
	dir = 1
	},
/turf/open/floor/plasteel/white,
/area/ruin_mapping/nullroom)
"GF" = (
/obj/machinery/modular_fabricator/exosuit_fab{
	auto_link = 0
	},
/obj/effect/turf_decal/tile/purple/anticorner/contrasted{
	dir = 4
	},
/turf/open/floor/plasteel/white,
/area/ruin_mapping/nullroom)
"GI" = (
/obj/machinery/computer/operating{
	dir = 4
	},
/obj/effect/turf_decal/tile/blue/anticorner/contrasted{
	dir = 1
	},
/turf/open/floor/plasteel/white,
/area/ruin_mapping/nullroom)
"GX" = (
/obj/effect/turf_decal/stripes/line,
/obj/machinery/rnd/destructive_analyzer,
/turf/open/floor/plasteel/freezer,
/area/ruin_mapping/nullroom)
"Iw" = (
/turf/open/floor/plasteel/dark/side{
	dir = 10
	},
/area/ruin_mapping/nullroom)
"Jd" = (
/obj/structure/table/optable,
/obj/machinery/defibrillator_mount/loaded{
	pixel_x = -28
	},
/obj/effect/turf_decal/tile/blue/half/contrasted{
	dir = 1
	},
/turf/open/floor/plasteel/white,
/area/ruin_mapping/nullroom)
"Jw" = (
/obj/machinery/chem_heater,
/turf/open/floor/plasteel/white,
/area/ruin_mapping/nullroom)
"JG" = (
/obj/effect/mob_spawn/human/oldsci{
	dir = 8
	},
/turf/open/floor/plasteel/showroomfloor,
/area/ruin_mapping/nullroom)
"Ks" = (
/obj/effect/decal/cleanable/dirt,
/obj/item/gun/energy/laser/retro/old{
	pixel_x = 2;
	pixel_y = 2
	},
/obj/item/gun/energy/laser/retro/old{
	pixel_x = -2;
	pixel_y = -2
	},
/turf/open/floor/plasteel/showroomfloor,
/area/ruin_mapping/nullroom)
"KM" = (
/obj/machinery/computer/rdconsole/core{
	dir = 8
	},
/obj/effect/turf_decal/stripes/line{
	dir = 1
	},
/turf/open/floor/plasteel/freezer,
/area/ruin_mapping/nullroom)
"KR" = (
/obj/machinery/door/firedoor,
/obj/structure/table/reinforced,
/obj/machinery/door/window/northleft,
/turf/open/floor/plating,
/area/ruin_mapping/nullroom)
"KT" = (
/obj/structure/showcase/mecha/marauder,
/obj/structure/window/spawner,
/turf/open/floor/wood,
/area/ruin_mapping/nullroom)
"Lb" = (
/obj/machinery/door/airlock/medical{
	name = "Medical"
	},
/turf/open/floor/plasteel/white/side,
/area/ruin_mapping/nullroom)
"Lr" = (
/obj/machinery/smartfridge/organ,
/obj/effect/turf_decal/tile/blue/anticorner/contrasted{
	dir = 8
	},
/turf/open/floor/plasteel/white,
/area/ruin_mapping/nullroom)
"MB" = (
/obj/structure/rack,
/obj/item/stack/sheet/iron/fifty,
/obj/item/stack/sheet/glass/fifty,
/obj/item/stack/sheet/mineral/copper/five,
/obj/item/stack/sheet/mineral/plasma/five,
/obj/effect/turf_decal/tile/purple/anticorner/contrasted{
	dir = 1
	},
/turf/open/floor/plasteel/white,
/area/ruin_mapping/nullroom)
"OX" = (
/obj/effect/turf_decal/tile/purple{
	dir = 1
	},
/turf/open/floor/plasteel/white,
/area/ruin_mapping/nullroom)
"Pw" = (
/obj/structure/lattice,
/turf/template_noop,
/area/template_noop)
"PK" = (
/obj/structure/rack,
/obj/item/storage/firstaid/regular,
/turf/open/floor/plasteel/white,
/area/ruin_mapping/nullroom)
"QB" = (
/turf/template_noop,
/area/template_noop)
"QI" = (
/obj/structure/bed/roller,
/obj/machinery/iv_drip,
/obj/effect/turf_decal/tile/blue/half/contrasted{
	dir = 8
	},
/turf/open/floor/plasteel/white,
/area/ruin_mapping/nullroom)
"Rr" = (
/turf/open/floor/plasteel/dark,
/area/ruin_mapping/nullroom)
"Sy" = (
/obj/effect/turf_decal/bot_white,
/turf/open/floor/plasteel/white,
/area/ruin_mapping/nullroom)
"SR" = (
/obj/item/reagent_containers/glass/beaker,
/obj/structure/table,
/obj/effect/turf_decal/tile/blue/half/contrasted{
	dir = 8
	},
/turf/open/floor/plasteel/white,
/area/ruin_mapping/nullroom)
"TD" = (
/turf/open/floor/plasteel,
/area/ruin_mapping/hallway)
"Uh" = (
/obj/machinery/suit_storage_unit{
	suit_type = /obj/item/clothing/suit/space/hardsuit/ancient
	},
/obj/effect/turf_decal/tile/purple{
	dir = 4
	},
/turf/open/floor/plasteel/white,
/area/ruin_mapping/nullroom)
"UJ" = (
/obj/effect/spawner/lootdrop/glowstick/lit,
/turf/open/floor/plasteel,
/area/ruin_mapping/hallway)
"UP" = (
/obj/machinery/modular_fabricator/autolathe/hacked,
/obj/machinery/door/firedoor,
/obj/machinery/door/window/northright,
/turf/open/floor/plating,
/area/ruin_mapping/nullroom)
"UX" = (
/obj/machinery/door/firedoor,
/obj/structure/table/reinforced,
/obj/machinery/door/window/westleft,
/turf/open/floor/plating,
/area/ruin_mapping/nullroom)
"Vu" = (
/obj/machinery/the_singularitygen,
/turf/open/floor/plasteel/dark,
/area/ruin_mapping/nullroom)
"VC" = (
/obj/structure/showcase/mecha/ripley,
/obj/structure/window/spawner,
/turf/open/floor/wood,
/area/ruin_mapping/nullroom)
"Wc" = (
/obj/item/healthanalyzer{
	desc = "A prototype hand-held body scanner able to distinguish vital signs of the subject.";
	name = "prototype health analyzer"
	},
/obj/structure/rack,
/obj/structure/window/spawner/north,
/turf/open/floor/wood,
/area/ruin_mapping/nullroom)
"Wt" = (
/obj/effect/abstract/open_area_marker{
	dir = 8
	},
/turf/open/floor/plasteel,
/area/ruin_mapping/hallway)
"Yp" = (
/obj/item/stock_parts/scanning_module{
	pixel_x = 2;
	pixel_y = 3
	},
/obj/item/stock_parts/manipulator,
/obj/machinery/recharger,
/obj/structure/table/glass/plasma,
/obj/effect/turf_decal/tile/purple{
	dir = 4
	},
/turf/open/floor/plasteel/white,
/area/ruin_mapping/nullroom)
"Zo" = (
/obj/structure/sign/departments/minsky/medical/medical2{
	pixel_y = -32
	},
/turf/open/floor/plasteel,
/area/ruin_mapping/hallway)

(1,1,1) = {"
QB
Pw
QB
QB
QB
lf
lf
lf
lf
TD
Wt
TD
lf
lf
lf
lf
lf
"}
(2,1,1) = {"
QB
Pw
Pw
Pw
Pw
lf
aY
lm
lf
TD
TD
TD
lf
GI
Jd
Lr
lf
"}
(3,1,1) = {"
QB
Pw
QB
QB
QB
lf
ww
Ks
cF
UJ
TD
TD
Dy
db
aW
Gw
lf
"}
(4,1,1) = {"
QB
Pw
QB
QB
QB
lf
hp
JG
lf
TD
TD
TD
lf
iZ
aW
cR
lf
"}
(5,1,1) = {"
Pw
lf
lf
lf
Gu
lf
lf
lf
lf
TD
TD
lf
lf
lf
hi
lf
lf
"}
(6,1,1) = {"
QB
lf
VC
Rr
Vu
Rr
Ff
lf
TD
TD
Zo
lf
Gz
aW
aW
QI
lf
"}
(7,1,1) = {"
QB
lf
bb
Rr
Rr
Rr
wJ
Gu
TD
TD
TD
Lb
aW
Jw
aW
sO
lf
"}
(8,1,1) = {"
QB
lf
bs
Rr
Rr
Rr
zy
lf
TD
TD
TD
lf
aW
Fe
na
SR
lf
"}
(9,1,1) = {"
QB
lf
KT
wX
uh
Iw
Wc
lf
lf
fF
lf
lf
rj
lf
UX
mn
lf
"}
(10,1,1) = {"
Pw
lf
lf
lf
jR
lf
lf
lf
OX
aW
zf
lf
BO
cr
TD
TD
lf
"}
(11,1,1) = {"
QB
lf
eh
ft
jW
lZ
aW
aW
aW
aW
aW
lV
TD
TD
hq
TD
lf
"}
(12,1,1) = {"
QB
lf
uO
aW
aW
mj
aW
aW
aW
aW
aW
lf
te
TD
de
de
lf
"}
(13,1,1) = {"
QB
lf
Uh
aW
aW
mW
Cq
nX
lf
lf
dS
lf
lf
xZ
de
de
lf
"}
(14,1,1) = {"
Pw
lf
lf
td
aW
of
Cv
nX
lf
MB
aW
mN
KR
de
de
de
lf
"}
(15,1,1) = {"
Pw
Pw
lf
gZ
aW
po
Fq
nX
lf
PK
aW
aW
Gu
de
de
de
lf
"}
(16,1,1) = {"
QB
Pw
lf
Yp
aW
KM
GX
hQ
lf
GF
Sy
tt
UP
de
de
de
lf
"}
(17,1,1) = {"
QB
QB
lf
lf
lf
lf
lf
lf
lf
lf
lf
lf
lf
de
gv
de
lf
"}
