//MAP CONVERTED BY dmm2tgm.py THIS HEADER COMMENT PREVENTS RECONVERSION, DO NOT REMOVE
"a" = (
/obj/effect/abstract/open_area_marker{
	dir = 8
	},
/turf/open/floor/plasteel,
/area/ruin_mapping/hallway)
"b" = (
/obj/machinery/door/poddoor/shutters/preopen,
/obj/effect/turf_decal/stripes/line{
	dir = 1
	},
/turf/open/floor/plasteel/dark,
/area/ruin_mapping/nullroom)
"c" = (
/obj/structure/shuttle/engine/heater{
	dir = 4
	},
/obj/structure/window/reinforced/tinted{
	dir = 8
	},
/turf/open/floor/plating,
/area/ruin_mapping/nullroom)
"f" = (
/obj/structure/shuttle/engine/propulsion/burst/right{
	dir = 4
	},
/turf/closed/wall/mineral/plastitanium,
/area/ruin_mapping/nullroom)
"g" = (
/obj/machinery/computer{
	dir = 4
	},
/turf/open/floor/mineral/titanium,
/area/ruin_mapping/nullroom)
"h" = (
/turf/open/floor/plasteel,
/area/ruin_mapping/room/one)
"i" = (
/obj/effect/turf_decal/stripes/corner{
	dir = 4
	},
/turf/open/floor/plasteel,
/area/ruin_mapping/room/one)
"r" = (
/obj/structure/rack,
/turf/open/floor/mineral/titanium,
/area/ruin_mapping/nullroom)
"s" = (
/obj/effect/spawner/lootdrop/crate_spawner,
/turf/open/floor/mineral/titanium,
/area/ruin_mapping/nullroom)
"t" = (
/obj/effect/spawner/structure/window/shuttle,
/turf/open/floor/plating,
/area/ruin_mapping/nullroom)
"v" = (
/obj/structure/shuttle/engine/propulsion/burst/left{
	dir = 4
	},
/turf/closed/wall/mineral/plastitanium,
/area/ruin_mapping/nullroom)
"B" = (
/turf/closed/wall/mineral/plastitanium,
/area/ruin_mapping/nullroom)
"C" = (
/obj/effect/turf_decal/stripes/line{
	dir = 1
	},
/turf/open/floor/plasteel,
/area/ruin_mapping/room/one)
"E" = (
/turf/open/floor/mineral/titanium,
/area/ruin_mapping/nullroom)
"I" = (
/obj/machinery/door/airlock/mining,
/turf/open/floor/plasteel,
/area/ruin_mapping/nullroom)
"K" = (
/turf/open/floor/plasteel,
/area/ruin_mapping/hallway)
"M" = (
/turf/closed/wall,
/area/ruin_mapping/nullroom)
"P" = (
/obj/structure/chair/fancy/shuttle{
	dir = 8
	},
/turf/open/floor/mineral/titanium,
/area/ruin_mapping/nullroom)
"Q" = (
/obj/effect/turf_decal/stripes/line{
	dir = 4
	},
/turf/open/floor/plasteel,
/area/ruin_mapping/room/one)
"S" = (
/turf/open/floor/engine,
/area/ruin_mapping/nullroom)
"T" = (
/obj/structure/shuttle/engine/propulsion/burst/cargo{
	dir = 4
	},
/turf/open/floor/plating,
/area/ruin_mapping/nullroom)
"U" = (
/turf/open/floor/plasteel/dark,
/area/ruin_mapping/room/two)
"X" = (
/obj/machinery/door/poddoor/shutters/preopen,
/obj/effect/turf_decal/stripes/line,
/turf/open/floor/mineral/titanium,
/area/ruin_mapping/nullroom)
"Y" = (
/turf/closed/wall/mineral/titanium,
/area/ruin_mapping/nullroom)

(1,1,1) = {"
M
K
a
K
M
M
M
M
M
M
M
M
M
"}
(2,1,1) = {"
M
h
h
h
h
h
h
h
h
h
h
h
M
"}
(3,1,1) = {"
M
h
h
h
h
h
h
h
h
h
h
h
M
"}
(4,1,1) = {"
M
h
h
h
h
h
h
h
h
h
h
h
M
"}
(5,1,1) = {"
M
h
h
h
h
h
h
h
h
h
h
h
M
"}
(6,1,1) = {"
M
h
h
h
h
h
h
h
h
h
h
h
M
"}
(7,1,1) = {"
M
Q
Q
Q
Q
Q
Q
i
h
h
h
h
M
"}
(8,1,1) = {"
M
S
S
S
S
S
S
C
h
h
h
h
M
"}
(9,1,1) = {"
M
S
Y
t
t
Y
S
C
h
h
h
h
M
"}
(10,1,1) = {"
M
Y
Y
g
g
Y
Y
M
M
I
M
M
M
"}
(11,1,1) = {"
M
Y
s
P
P
r
Y
M
U
U
U
U
M
"}
(12,1,1) = {"
M
Y
E
E
E
E
X
b
U
U
U
U
M
"}
(13,1,1) = {"
M
Y
E
s
E
E
X
b
U
U
U
U
M
"}
(14,1,1) = {"
M
Y
s
E
E
E
X
b
U
U
U
U
M
"}
(15,1,1) = {"
M
B
B
c
c
B
B
M
U
U
U
U
M
"}
(16,1,1) = {"
M
S
f
T
T
v
S
M
U
U
U
U
M
"}
(17,1,1) = {"
M
M
M
M
M
M
M
M
M
M
M
M
M
"}
