//MAP CONVERTED BY dmm2tgm.py THIS HEADER COMMENT PREVENTS RECONVERSION, DO NOT REMOVE
"a" = (
/obj/structure/lattice,
/turf/template_noop/open,
/area/ruin_mapping/nullroom)
"c" = (
/turf/open/floor/plasteel,
/area/ruin_mapping/hallway)
"d" = (
/obj/effect/abstract/open_area_marker{
	dir = 1
	},
/turf/open/floor/plasteel,
/area/ruin_mapping/hallway)
"g" = (
/turf/closed/wall,
/area/ruin_mapping/nullroom)
"l" = (
/obj/machinery/the_singularitygen,
/turf/open/floor/plating,
/area/ruin_mapping/nullroom)
"o" = (
/obj/machinery/field/generator,
/turf/open/floor/plating,
/area/ruin_mapping/nullroom)
"t" = (
/turf/open/floor/plating,
/area/ruin_mapping/nullroom)
"A" = (
/obj/effect/abstract/open_area_marker,
/turf/open/floor/plasteel,
/area/ruin_mapping/hallway)
"C" = (
/turf/closed/wall/r_wall,
/area/ruin_mapping/nullroom)
"F" = (
/obj/effect/abstract/open_area_marker{
	dir = 4
	},
/turf/open/floor/plasteel,
/area/ruin_mapping/hallway)
"G" = (
/obj/effect/abstract/open_area_marker{
	dir = 8
	},
/turf/open/floor/plasteel,
/area/ruin_mapping/hallway)
"N" = (
/turf/template_noop/open,
/area/ruin_mapping/nullroom)
"R" = (
/obj/effect/spawner/structure/window/reinforced,
/turf/open/floor/plating,
/area/ruin_mapping/nullroom)
"X" = (
/turf/template_noop,
/area/template_noop)

(1,1,1) = {"
X
X
X
X
X
g
g
g
g
c
G
c
g
g
g
g
X
X
X
X
X
"}
(2,1,1) = {"
X
X
g
g
g
g
c
c
c
c
c
c
c
c
c
g
g
g
g
X
X
"}
(3,1,1) = {"
X
g
g
c
c
c
c
c
c
c
c
c
c
c
c
c
c
c
g
g
X
"}
(4,1,1) = {"
X
g
c
c
c
c
c
c
c
c
c
c
c
c
c
c
c
c
c
g
X
"}
(5,1,1) = {"
X
g
c
c
c
c
c
c
c
c
c
c
c
c
c
c
c
c
c
g
X
"}
(6,1,1) = {"
g
g
c
c
c
C
C
R
R
R
C
R
R
R
C
C
c
c
c
g
g
"}
(7,1,1) = {"
g
c
c
c
c
C
t
t
t
N
t
N
t
t
t
C
c
c
c
c
g
"}
(8,1,1) = {"
g
c
c
c
c
R
t
o
t
N
t
N
t
o
t
R
c
c
c
c
g
"}
(9,1,1) = {"
g
c
c
c
c
R
t
t
N
a
t
a
N
t
t
R
c
c
c
c
g
"}
(10,1,1) = {"
c
c
c
c
c
R
N
N
a
t
t
t
a
N
N
R
c
c
c
c
c
"}
(11,1,1) = {"
d
c
c
c
c
C
t
t
t
t
l
t
t
t
t
C
c
c
c
c
A
"}
(12,1,1) = {"
c
c
c
c
c
R
N
N
a
t
t
t
a
N
N
R
c
c
c
c
c
"}
(13,1,1) = {"
g
c
c
c
c
R
t
t
N
a
t
a
N
t
t
R
c
c
c
c
g
"}
(14,1,1) = {"
g
c
c
c
c
R
t
o
t
N
t
N
t
o
t
R
c
c
c
c
g
"}
(15,1,1) = {"
g
c
c
c
c
C
t
t
t
N
t
N
t
t
t
C
c
c
c
c
g
"}
(16,1,1) = {"
g
g
c
c
c
C
C
R
R
R
C
R
R
R
C
C
c
c
c
g
g
"}
(17,1,1) = {"
X
g
c
c
c
c
c
c
c
c
c
c
c
c
c
c
c
c
c
g
X
"}
(18,1,1) = {"
X
g
c
c
c
c
c
c
c
c
c
c
c
c
c
c
c
c
c
g
X
"}
(19,1,1) = {"
X
g
g
c
c
c
c
c
c
c
c
c
c
c
c
c
c
c
g
g
X
"}
(20,1,1) = {"
X
X
g
g
g
g
c
c
c
c
c
c
c
c
c
g
g
g
g
X
X
"}
(21,1,1) = {"
X
X
X
X
X
g
g
g
g
c
F
c
g
g
g
g
X
X
X
X
X
"}
