//MAP CONVERTED BY dmm2tgm.py THIS HEADER COMMENT PREVENTS RECONVERSION, DO NOT REMOVE
"a" = (
/turf/closed/mineral/random/mining,
/area/mining/surface/outdoors)
"b" = (
/turf/closed/mineral/random/mining,
/area/mining/surface/outdoors)
"c" = (
/obj/effect/decal/remains/human,
/turf/closed/mineral/random/mining,
/area/mining/surface/outdoors)
"d" = (
/turf/closed/indestructible/riveted,
/area/mining/surface/outdoors)
"i" = (
/obj/machinery/wish_granter,
/obj/effect/mapping_helpers/no_lava,
/obj/effect/abstract/mining_landmark,
/turf/closed/mineral/random/mining,
/area/mining/surface/outdoors)
"P" = (
/turf/template_noop,
/area/template_noop)

(1,1,1) = {"
P
P
P
P
P
a
a
a
a
a
a
a
a
b
a
b
b
b
b
b
b
a
a
a
a
a
a
a
P
P
"}
(2,1,1) = {"
P
P
P
P
P
a
a
a
a
a
a
a
a
b
a
b
b
c
b
b
b
b
a
a
a
a
a
a
P
P
"}
(3,1,1) = {"
P
P
P
a
a
a
b
a
a
a
a
a
a
a
b
a
b
b
b
a
a
b
b
a
a
b
b
a
P
P
"}
(4,1,1) = {"
P
P
P
a
b
b
b
a
a
a
a
a
a
a
b
b
b
a
a
b
b
b
b
b
b
b
b
a
P
P
"}
(5,1,1) = {"
P
P
P
b
b
b
b
a
a
a
a
a
a
a
a
a
b
b
b
b
b
b
b
b
b
b
b
a
a
P
"}
(6,1,1) = {"
P
P
a
a
a
a
a
a
a
a
a
a
a
b
b
b
b
b
b
b
b
b
b
b
b
b
b
b
a
P
"}
(7,1,1) = {"
P
P
a
a
a
a
a
a
a
a
b
b
b
b
b
b
b
c
b
b
c
b
b
b
c
b
b
b
b
a
"}
(8,1,1) = {"
P
P
a
a
a
a
a
a
a
a
b
b
b
b
b
b
b
b
b
b
b
b
b
b
b
b
b
b
b
a
"}
(9,1,1) = {"
P
P
b
a
a
a
a
a
a
a
b
b
b
b
c
b
b
b
b
b
b
b
b
b
b
b
b
b
b
b
"}
(10,1,1) = {"
P
a
a
a
a
a
a
a
a
a
a
a
b
b
b
b
b
c
b
b
b
b
b
b
b
b
c
b
b
b
"}
(11,1,1) = {"
P
a
a
b
a
a
a
a
a
a
a
a
a
b
b
b
b
b
b
b
b
b
b
c
b
b
b
b
b
b
"}
(12,1,1) = {"
P
a
b
a
a
a
b
b
a
a
c
b
b
b
b
b
c
b
c
b
b
b
b
b
b
b
b
b
b
b
"}
(13,1,1) = {"
P
a
b
b
b
b
b
b
b
b
b
b
c
c
b
c
c
b
b
b
b
b
b
b
b
b
b
b
c
b
"}
(14,1,1) = {"
a
a
b
c
b
b
b
b
c
b
c
d
d
d
d
d
b
b
b
b
b
b
c
b
b
b
b
b
b
b
"}
(15,1,1) = {"
a
a
b
b
b
b
c
b
b
b
b
d
d
d
d
d
b
c
b
b
c
b
a
b
b
b
b
b
b
b
"}
(16,1,1) = {"
a
a
b
b
b
b
b
b
b
c
b
d
d
i
d
d
b
b
a
a
b
b
a
a
b
b
b
b
b
b
"}
(17,1,1) = {"
a
a
b
b
b
b
b
c
b
b
c
d
d
d
d
d
c
c
a
a
a
a
a
a
a
b
b
a
b
b
"}
(18,1,1) = {"
a
a
b
a
a
a
b
b
b
b
b
d
d
d
d
d
b
c
b
a
a
a
a
a
b
b
b
c
a
a
"}
(19,1,1) = {"
a
a
b
a
a
a
b
b
b
b
b
c
b
c
c
b
c
b
b
a
a
a
a
a
b
a
b
b
a
a
"}
(20,1,1) = {"
a
a
b
b
b
b
b
b
c
b
b
b
c
b
b
b
b
b
a
a
a
a
a
a
a
a
a
a
a
a
"}
(21,1,1) = {"
a
a
b
b
b
b
b
b
b
b
b
b
b
c
b
b
b
b
b
a
a
a
a
a
a
a
a
a
a
a
"}
(22,1,1) = {"
a
a
b
b
b
b
a
b
b
b
a
b
b
b
b
b
b
b
b
b
a
a
a
a
a
a
a
a
a
a
"}
(23,1,1) = {"
a
a
a
a
a
a
b
b
b
b
b
b
b
b
b
b
c
b
b
a
a
a
a
a
a
a
a
a
a
a
"}
(24,1,1) = {"
a
a
a
a
a
a
c
b
b
b
b
b
b
b
c
b
b
b
b
a
a
a
a
a
a
a
a
a
a
a
"}
(25,1,1) = {"
P
a
a
a
a
a
b
b
b
b
b
b
b
b
b
b
a
a
a
a
a
a
a
a
a
a
a
a
a
a
"}
(26,1,1) = {"
P
P
a
a
a
a
a
a
b
b
c
b
b
b
b
b
a
a
a
a
a
b
a
a
a
a
a
a
a
a
"}
(27,1,1) = {"
P
P
P
a
a
a
a
a
a
a
a
b
c
b
b
a
b
b
b
b
b
b
a
a
a
a
a
a
a
a
"}
(28,1,1) = {"
P
P
P
P
a
a
a
a
a
a
a
a
b
b
b
b
b
b
b
b
a
a
a
a
a
P
P
P
P
P
"}
(29,1,1) = {"
P
P
P
P
P
a
a
a
a
a
a
a
a
b
b
b
b
a
a
a
a
a
P
P
P
P
P
P
P
P
"}
(30,1,1) = {"
P
P
P
P
P
P
a
a
a
a
a
a
a
a
a
a
a
a
a
P
P
P
P
P
P
P
P
P
P
P
"}
