//MAP CONVERTED BY dmm2tgm.py THIS HEADER COMMENT PREVENTS RECONVERSION, DO NOT REMOVE
"a" = (
/turf/template_noop,
/area/template_noop)
"b" = (
/turf/closed/mineral/random/mining,
/area/mining/surface/outdoors)
"c" = (
/turf/closed/mineral/random/mining,
/area/mining/surface/outdoors)
"d" = (
/obj/structure/stone_tile/block{
	dir = 8
	},
/obj/structure/stone_tile/block{
	dir = 4
	},
/turf/closed/mineral/random/mining,
/area/mining/surface/outdoors)
"e" = (
/obj/structure/stone_tile/block{
	dir = 8
	},
/obj/structure/stone_tile/block/cracked{
	dir = 4
	},
/turf/closed/mineral/random/mining,
/area/mining/surface/outdoors)
"f" = (
/obj/structure/stone_tile/block{
	dir = 4
	},
/obj/structure/stone_tile/block/cracked{
	dir = 8
	},
/turf/closed/mineral/random/mining,
/area/mining/surface/outdoors)
"g" = (
/obj/structure/stone_tile{
	dir = 4
	},
/turf/closed/mineral/random/mining,
/area/mining/surface/outdoors)
"h" = (
/obj/structure/stone_tile{
	dir = 1
	},
/turf/closed/mineral/random/mining,
/area/mining/surface/outdoors)
"i" = (
/obj/structure/stone_tile{
	dir = 8
	},
/obj/structure/stone_tile{
	dir = 1
	},
/obj/structure/stone_tile/cracked,
/turf/closed/mineral/random/mining,
/area/mining/surface/outdoors)
"j" = (
/obj/structure/stone_tile,
/obj/structure/stone_tile{
	dir = 4
	},
/obj/structure/stone_tile/cracked{
	dir = 8
	},
/turf/closed/mineral/random/mining,
/area/mining/surface/outdoors)
"k" = (
/obj/structure/stone_tile/cracked,
/obj/structure/stone_tile{
	dir = 8
	},
/obj/structure/stone_tile{
	dir = 1
	},
/turf/closed/mineral/random/mining,
/area/mining/surface/outdoors)
"l" = (
/obj/structure/stone_tile{
	dir = 8
	},
/obj/structure/stone_tile,
/obj/structure/stone_tile/cracked{
	dir = 4
	},
/turf/closed/mineral/random/mining,
/area/mining/surface/outdoors)
"m" = (
/obj/structure/stone_tile{
	dir = 4
	},
/obj/structure/stone_tile{
	dir = 8
	},
/obj/structure/stone_tile/cracked,
/turf/closed/mineral/random/mining,
/area/mining/surface/outdoors)
"n" = (
/obj/structure/stone_tile/block{
	dir = 8
	},
/obj/structure/stone_tile/block{
	dir = 4
	},
/mob/living/simple_animal/hostile/megafauna/blood_drunk_miner/hunter,
/turf/closed/mineral/random/mining,
/area/mining/surface/outdoors)
"o" = (
/obj/structure/stone_tile/cracked{
	dir = 4
	},
/turf/closed/mineral/random/mining,
/area/mining/surface/outdoors)
"p" = (
/obj/structure/stone_tile{
	dir = 1
	},
/obj/structure/stone_tile/cracked{
	dir = 8
	},
/obj/structure/stone_tile,
/turf/closed/mineral/random/mining,
/area/mining/surface/outdoors)
"q" = (
/obj/structure/stone_tile{
	dir = 4
	},
/obj/structure/stone_tile/cracked,
/obj/structure/stone_tile{
	dir = 8
	},
/turf/closed/mineral/random/mining,
/area/mining/surface/outdoors)
"r" = (
/obj/structure/stone_tile{
	dir = 1
	},
/obj/structure/stone_tile{
	dir = 8
	},
/obj/structure/stone_tile,
/turf/closed/mineral/random/mining,
/area/mining/surface/outdoors)
"s" = (
/obj/structure/stone_tile/surrounding_tile/cracked,
/turf/closed/mineral/random/mining,
/area/mining/surface/outdoors)
"t" = (
/obj/structure/stone_tile/block/cracked,
/turf/closed/mineral/random/mining,
/area/mining/surface/outdoors)
"u" = (
/obj/structure/stone_tile/surrounding_tile{
	dir = 8
	},
/turf/closed/mineral/random/mining,
/area/mining/surface/outdoors)
"v" = (
/obj/structure/stone_tile/surrounding/cracked{
	dir = 6
	},
/obj/structure/stone_tile/center,
/turf/closed/mineral/random/mining,
/area/mining/surface/outdoors)
"E" = (
/obj/structure/stone_tile/block{
	dir = 8
	},
/turf/closed/mineral/random/mining,
/area/mining/surface/outdoors)
"L" = (
/obj/structure/stone_tile/block/cracked{
	dir = 4
	},
/turf/closed/mineral/random/mining,
/area/mining/surface/outdoors)

(1,1,1) = {"
a
a
a
a
a
a
a
a
b
b
b
b
b
a
a
a
"}
(2,1,1) = {"
a
b
b
b
a
a
b
b
b
c
c
b
b
b
a
a
"}
(3,1,1) = {"
b
b
b
b
b
b
b
b
c
g
m
c
c
b
b
a
"}
(4,1,1) = {"
b
c
c
b
b
b
c
c
g
k
h
q
c
c
b
b
"}
(5,1,1) = {"
E
c
c
E
c
c
c
g
i
c
c
h
s
c
c
b
"}
(6,1,1) = {"
E
d
e
e
d
f
d
f
e
d
n
f
t
v
c
b
"}
(7,1,1) = {"
c
c
L
c
c
L
c
h
j
c
c
o
u
c
b
b
"}
(8,1,1) = {"
b
b
b
c
c
c
c
c
h
l
o
r
c
b
b
b
"}
(9,1,1) = {"
a
b
b
b
b
c
c
c
c
h
p
c
c
b
b
a
"}
(10,1,1) = {"
a
a
a
b
b
b
b
b
c
c
c
c
b
b
a
a
"}
(11,1,1) = {"
a
a
a
a
a
b
b
b
b
b
b
b
b
b
a
a
"}
