//MAP CONVERTED BY dmm2tgm.py THIS HEADER COMMENT PREVENTS RECONVERSION, DO NOT REMOVE
"a" = (
/turf/closed/mineral/random/mining,
/area/mining/surface/outdoors)
"b" = (
/turf/closed/mineral/random/mining,
/area/mining/surface/outdoors)
"c" = (
/turf/open/lava/smooth/lava_land_surface,
/area/mining/surface/outdoors)
"e" = (
/turf/open/lava/smooth,
/area/ruin/powered/gluttony)
"g" = (
/obj/effect/gluttony,
/turf/open/floor/plasteel/freezer,
/area/ruin/powered/gluttony)
"h" = (
/obj/item/veilrender/vealrender,
/turf/open/floor/plasteel/freezer,
/area/ruin/powered/gluttony)
"i" = (
/turf/open/floor/plasteel/freezer,
/area/ruin/powered/gluttony)
"j" = (
/obj/item/trash/plate,
/turf/open/floor/plasteel/freezer,
/area/ruin/powered/gluttony)
"l" = (
/obj/item/trash/candy,
/turf/open/floor/plasteel/freezer,
/area/ruin/powered/gluttony)
"m" = (
/obj/item/trash/raisins,
/turf/open/floor/plasteel/freezer,
/area/ruin/powered/gluttony)
"n" = (
/obj/item/trash/pistachios,
/turf/open/floor/plasteel/freezer,
/area/ruin/powered/gluttony)
"o" = (
/obj/item/trash/popcorn,
/turf/open/floor/plasteel/freezer,
/area/ruin/powered/gluttony)
"p" = (
/obj/item/trash/semki,
/turf/open/floor/plasteel/freezer,
/area/ruin/powered/gluttony)
"q" = (
/obj/item/trash/syndi_cakes,
/turf/open/floor/plasteel/freezer,
/area/ruin/powered/gluttony)
"r" = (
/obj/effect/gluttony,
/obj/machinery/light/small{
	dir = 1
	},
/turf/open/floor/plasteel/freezer,
/area/ruin/powered/gluttony)
"t" = (
/obj/machinery/light/small{
	dir = 1
	},
/turf/open/floor/plasteel/freezer,
/area/ruin/powered/gluttony)
"v" = (
/obj/machinery/light/small,
/turf/open/floor/plasteel/freezer,
/area/ruin/powered/gluttony)
"w" = (
/turf/template_noop,
/area/template_noop)
"z" = (
/obj/item/trash/plate,
/obj/machinery/light/small{
	dir = 8
	},
/turf/open/floor/plasteel/freezer,
/area/ruin/powered/gluttony)
"A" = (
/obj/machinery/light/small{
	dir = 4
	},
/turf/open/floor/plasteel/freezer,
/area/ruin/powered/gluttony)
"K" = (
/obj/item/reagent_containers/syringe/gluttony,
/obj/effect/abstract/mining_landmark,
/turf/open/floor/plasteel/freezer,
/area/ruin/powered/gluttony)
"R" = (
/turf/closed/indestructible/riveted/uranium,
/area/ruin/powered/gluttony)
"S" = (
/obj/machinery/door/airlock/uranium,
/obj/structure/fans/tiny/invisible,
/turf/open/floor/plasteel/freezer,
/area/ruin/powered/gluttony)

(1,1,1) = {"
w
w
w
a
a
a
a
a
a
a
a
a
a
a
a
w
w
w
w
w
"}
(2,1,1) = {"
w
w
a
a
b
b
b
b
b
b
b
a
a
a
a
a
a
a
w
w
"}
(3,1,1) = {"
w
w
a
a
b
b
b
c
c
c
b
c
c
c
b
b
a
a
w
w
"}
(4,1,1) = {"
w
a
a
a
b
b
b
c
R
R
S
R
R
c
b
a
a
a
a
a
"}
(5,1,1) = {"
w
a
a
a
a
b
b
c
R
h
i
o
R
c
b
a
a
a
a
a
"}
(6,1,1) = {"
w
a
a
a
a
b
b
c
R
i
i
v
R
c
b
b
b
b
b
a
"}
(7,1,1) = {"
a
a
b
b
b
b
b
c
R
i
l
i
R
c
b
b
b
b
b
a
"}
(8,1,1) = {"
a
b
c
c
c
c
c
c
R
t
i
m
R
c
c
c
c
c
c
a
"}
(9,1,1) = {"
a
b
c
R
R
R
R
R
R
g
m
v
R
R
R
R
R
R
c
a
"}
(10,1,1) = {"
a
a
c
R
e
R
r
g
g
g
g
i
p
i
z
l
i
R
c
a
"}
(11,1,1) = {"
a
b
c
R
K
g
g
g
g
g
n
i
i
i
i
i
i
S
b
a
"}
(12,1,1) = {"
a
a
c
R
e
R
r
g
g
g
i
g
i
l
A
i
q
R
c
a
"}
(13,1,1) = {"
a
b
c
R
R
R
R
R
R
g
i
v
R
R
R
R
R
R
c
a
"}
(14,1,1) = {"
a
b
c
c
c
c
c
c
R
r
i
i
R
c
c
c
c
c
a
a
"}
(15,1,1) = {"
a
a
b
b
b
b
b
c
R
i
g
i
R
c
b
b
b
b
a
a
"}
(16,1,1) = {"
a
a
b
a
b
b
b
c
R
j
i
v
R
c
b
b
b
a
a
a
"}
(17,1,1) = {"
a
a
a
a
b
b
b
c
R
i
n
i
R
c
b
b
b
a
a
w
"}
(18,1,1) = {"
w
w
a
a
a
b
b
c
R
R
S
R
R
c
b
a
a
a
a
w
"}
(19,1,1) = {"
w
w
a
a
a
a
a
c
c
c
b
c
c
c
a
a
a
a
w
w
"}
(20,1,1) = {"
w
w
w
w
a
a
a
a
a
a
a
a
a
a
a
a
w
w
w
w
"}
