//MAP CONVERTED BY dmm2tgm.py THIS HEADER COMMENT PREVENTS RECONVERSION, DO NOT REMOVE
"a" = (
/turf/template_noop,
/area/template_noop)
"b" = (
/turf/closed/mineral/random/mining,
/area/mining/surface/outdoors/unexplored)
"c" = (
/obj/item/clockwork/alloy_shards/small,
/turf/closed/mineral/random/mining,
/area/mining/surface/outdoors/unexplored)
"e" = (
/obj/item/stack/tile/brass,
/turf/open/floor/clockwork{
	initial_gas_mix = "TEMP=2.7"
	},
/area/mining/surface/outdoors/unexplored)
"f" = (
/turf/closed/mineral/random/mining,
/area/mining/surface/outdoors/unexplored)
"g" = (
/obj/item/clockwork/alloy_shards/medium/gear_bit,
/turf/closed/mineral/random/mining,
/area/mining/surface/outdoors/unexplored)
"h" = (
/turf/open/floor/clockwork{
	initial_gas_mix = "TEMP=2.7"
	},
/area/mining/surface/outdoors/unexplored)
"i" = (
/obj/structure/grille/ratvar/broken,
/turf/closed/mineral/random/mining,
/area/mining/surface/outdoors/unexplored)
"j" = (
/turf/closed/wall/clockwork,
/area/mining/surface/outdoors/unexplored)
"k" = (
/obj/item/clockwork/alloy_shards/small,
/turf/open/floor/clockwork{
	initial_gas_mix = "TEMP=2.7"
	},
/area/mining/surface/outdoors/unexplored)
"l" = (
/turf/open/lava/smooth/lava_land_surface,
/area/mining/surface/outdoors/unexplored)
"m" = (
/obj/item/clockwork/alloy_shards/medium,
/turf/closed/mineral/random/mining,
/area/mining/surface/outdoors/unexplored)
"n" = (
/obj/item/clockwork/component/belligerent_eye/blind_eye,
/turf/closed/mineral/random/mining,
/area/mining/surface/outdoors/unexplored)
"o" = (
/obj/item/clockwork/alloy_shards/large,
/turf/closed/mineral/random/mining,
/area/mining/surface/outdoors/unexplored)
"p" = (
/obj/item/clockwork/alloy_shards/medium,
/turf/open/floor/clockwork{
	initial_gas_mix = "TEMP=2.7"
	},
/area/mining/surface/outdoors/unexplored)
"q" = (
/obj/structure/lattice/catwalk/clockwork,
/turf/open/lava/smooth/lava_land_surface,
/area/mining/surface/outdoors/unexplored)
"r" = (
/obj/structure/lattice/clockwork,
/turf/closed/mineral/random/mining,
/area/mining/surface/outdoors/unexplored)
"s" = (
/obj/item/clockwork/alloy_shards/large,
/turf/open/floor/clockwork{
	initial_gas_mix = "TEMP=2.7"
	},
/area/mining/surface/outdoors/unexplored)
"t" = (
/obj/item/stack/tile/brass,
/turf/closed/mineral/random/mining,
/area/mining/surface/outdoors/unexplored)
"u" = (
/obj/structure/grille/ratvar,
/turf/open/floor/clockwork{
	initial_gas_mix = "TEMP=2.7"
	},
/area/mining/surface/outdoors/unexplored)
"v" = (
/obj/effect/abstract/mining_landmark,
/turf/open/floor/clockwork{
	initial_gas_mix = "TEMP=2.7"
	},
/area/mining/surface/outdoors/unexplored)
"w" = (
/obj/structure/grille/ratvar/broken,
/turf/open/floor/clockwork{
	initial_gas_mix = "TEMP=2.7"
	},
/area/mining/surface/outdoors/unexplored)
"y" = (
/obj/item/clockwork/component/geis_capacitor/fallen_armor,
/turf/open/floor/clockwork{
	initial_gas_mix = "TEMP=2.7"
	},
/area/mining/surface/outdoors/unexplored)
"A" = (
/obj/item/clockwork/alloy_shards/clockgolem_remains,
/turf/open/floor/clockwork{
	initial_gas_mix = "TEMP=2.7"
	},
/area/mining/surface/outdoors/unexplored)
"B" = (
/obj/item/twohanded/clockwork/brass_spear,
/turf/open/floor/clockwork{
	initial_gas_mix = "TEMP=2.7"
	},
/area/mining/surface/outdoors/unexplored)
"C" = (
/obj/item/clockwork/alloy_shards/medium/gear_bit,
/turf/open/floor/clockwork{
	initial_gas_mix = "TEMP=2.7"
	},
/area/mining/surface/outdoors/unexplored)
"D" = (
/obj/structure/grille/ratvar,
/turf/closed/mineral/random/mining,
/area/mining/surface/outdoors/unexplored)
"E" = (
/obj/item/clockwork/alloy_shards/clockgolem_remains,
/turf/closed/mineral/random/mining,
/area/mining/surface/outdoors/unexplored)
"F" = (
/obj/structure/dead_ratvar,
/turf/open/floor/clockwork{
	initial_gas_mix = "TEMP=2.7"
	},
/area/mining/surface/outdoors/unexplored)
"L" = (
/obj/item/clockwork/alloy_shards/medium/gear_bit,
/turf/closed/mineral/random/mining,
/area/mining/surface/outdoors/unexplored)
"M" = (
/obj/item/stack/tile/brass/fifty,
/turf/closed/mineral/random/mining,
/area/mining/surface/outdoors/unexplored)
"P" = (
/obj/item/clockwork/alloy_shards/small,
/turf/closed/mineral/random/mining,
/area/mining/surface/outdoors/unexplored)
"U" = (
/obj/item/clockwork/alloy_shards/medium,
/turf/closed/mineral/random/mining,
/area/mining/surface/outdoors/unexplored)
"W" = (
/obj/structure/lattice/clockwork,
/turf/closed/mineral/random/mining,
/area/mining/surface/outdoors/unexplored)
"Y" = (
/obj/item/stack/tile/brass,
/turf/closed/mineral/random/mining,
/area/mining/surface/outdoors/unexplored)
"Z" = (
/obj/item/clockwork/alloy_shards/large,
/turf/closed/mineral/random/mining,
/area/mining/surface/outdoors/unexplored)

(1,1,1) = {"
a
a
a
a
a
a
a
a
a
a
a
a
f
f
f
f
f
f
f
f
f
a
a
a
"}
(2,1,1) = {"
a
a
a
a
a
a
a
a
f
f
f
f
f
c
j
e
b
b
g
f
f
f
a
a
"}
(3,1,1) = {"
a
a
a
a
f
f
f
f
f
f
r
f
p
w
j
j
c
l
b
b
f
f
f
a
"}
(4,1,1) = {"
a
a
a
f
f
f
f
l
l
r
b
b
l
j
j
j
p
l
b
h
c
r
f
a
"}
(5,1,1) = {"
a
f
f
f
f
b
l
l
p
h
c
l
l
l
j
l
b
l
l
D
h
r
f
a
"}
(6,1,1) = {"
a
f
f
f
c
h
m
l
l
c
l
l
l
l
w
l
l
l
m
c
h
f
f
a
"}
(7,1,1) = {"
f
f
f
b
b
l
l
l
l
h
b
l
l
l
l
l
l
l
l
c
f
f
f
a
"}
(8,1,1) = {"
f
f
f
g
c
b
l
l
l
l
n
h
r
l
l
b
l
l
l
l
f
f
f
a
"}
(9,1,1) = {"
f
b
c
b
b
l
l
l
l
t
h
b
h
w
p
b
g
l
l
b
b
f
f
a
"}
(10,1,1) = {"
f
h
l
l
l
l
l
l
b
b
p
r
F
b
h
A
b
l
l
l
m
f
f
a
"}
(11,1,1) = {"
P
i
j
j
l
l
l
l
l
b
h
k
h
h
h
r
l
l
l
l
l
f
f
f
"}
(12,1,1) = {"
f
j
j
j
h
l
l
b
l
q
r
h
h
h
c
q
l
b
l
l
b
h
o
f
"}
(13,1,1) = {"
Y
P
b
l
l
l
b
p
s
r
h
h
h
h
h
h
h
l
l
l
l
b
b
f
"}
(14,1,1) = {"
a
f
b
m
l
l
l
b
h
h
k
h
h
h
h
h
c
b
l
l
b
b
f
f
"}
(15,1,1) = {"
a
f
f
l
l
l
l
h
h
h
h
h
v
h
k
B
h
l
l
l
l
b
f
f
"}
(16,1,1) = {"
a
a
f
f
l
l
l
q
b
h
h
h
h
h
h
s
b
l
l
l
l
f
f
a
"}
(17,1,1) = {"
a
f
f
f
l
l
b
l
q
r
h
h
h
h
h
b
s
r
l
r
l
l
f
f
"}
(18,1,1) = {"
a
f
f
l
l
b
b
h
b
h
h
h
h
h
r
k
b
C
r
h
b
b
U
f
"}
(19,1,1) = {"
f
b
l
l
l
l
h
b
h
h
h
h
h
h
h
r
j
h
c
h
r
h
f
f
"}
(20,1,1) = {"
f
l
l
l
l
b
b
p
h
c
h
k
h
h
o
b
l
l
l
b
E
r
M
Z
"}
(21,1,1) = {"
L
b
l
l
l
l
l
r
h
r
h
h
h
h
y
l
l
l
l
l
l
j
f
W
"}
(22,1,1) = {"
P
c
b
l
l
b
h
h
t
b
h
h
h
h
h
m
b
l
l
l
h
j
f
f
"}
(23,1,1) = {"
f
f
m
n
b
h
l
o
j
u
r
p
h
r
h
b
l
l
l
b
b
w
W
f
"}
(24,1,1) = {"
f
f
b
b
l
l
l
j
j
q
p
h
m
e
h
j
j
l
l
c
l
f
f
f
"}
(25,1,1) = {"
f
f
f
l
l
l
l
j
l
l
b
h
r
e
h
l
l
l
l
l
f
f
f
a
"}
(26,1,1) = {"
f
f
f
c
b
l
l
l
l
l
l
g
q
b
h
l
l
l
c
U
f
f
a
a
"}
(27,1,1) = {"
f
f
f
f
h
b
l
l
l
l
l
l
l
l
l
l
l
l
l
f
f
f
a
a
"}
(28,1,1) = {"
a
f
f
f
c
b
l
b
l
l
l
l
l
l
l
l
b
l
f
f
f
a
a
a
"}
(29,1,1) = {"
a
f
f
f
f
f
f
c
b
f
c
l
l
l
l
c
Z
f
f
f
f
a
a
a
"}
(30,1,1) = {"
a
a
f
f
f
g
c
f
f
f
f
U
l
b
l
f
f
f
f
a
a
a
a
a
"}
(31,1,1) = {"
a
a
a
a
f
f
f
f
f
f
f
f
f
P
f
f
f
f
a
a
a
a
a
a
"}
(32,1,1) = {"
a
a
a
a
a
a
a
a
a
a
a
f
f
f
P
a
a
a
a
a
a
a
a
a
"}
