//MAP CONVERTED BY dmm2tgm.py THIS HEADER COMMENT PREVENTS RECONVERSION, DO NOT REMOVE
"a" = (
/turf/template_noop,
/area/template_noop)
"b" = (
/obj/structure/alien/weeds,
/obj/structure/alien/resin/wall,
/turf/closed/mineral/random/mining,
/area/ruin/unpowered/xenonest)
"d" = (
/obj/structure/alien/resin/wall,
/obj/structure/alien/weeds,
/turf/closed/mineral/random/mining,
/area/ruin/unpowered/xenonest)
"e" = (
/obj/structure/alien/weeds,
/obj/structure/alien/egg/burst,
/turf/closed/mineral/random/mining,
/area/ruin/unpowered/xenonest)
"f" = (
/obj/structure/alien/weeds,
/obj/structure/alien/weeds,
/turf/closed/mineral/random/mining,
/area/ruin/unpowered/xenonest)
"g" = (
/obj/structure/alien/weeds,
/turf/closed/mineral/random/mining,
/area/ruin/unpowered/xenonest)
"i" = (
/obj/structure/alien/weeds,
/obj/structure/bed/nest,
/turf/closed/mineral/random/mining,
/area/ruin/unpowered/xenonest)
"j" = (
/obj/structure/alien/weeds,
/mob/living/simple_animal/hostile/alien,
/turf/closed/mineral/random/mining,
/area/ruin/unpowered/xenonest)
"l" = (
/obj/structure/alien/weeds/node,
/turf/closed/mineral/random/mining,
/area/ruin/unpowered/xenonest)
"n" = (
/turf/closed/mineral/random/mining,
/area/template_noop)
"o" = (
/obj/structure/alien/weeds,
/obj/structure/bed/nest,
/obj/effect/decal/cleanable/blood/gibs,
/obj/item/gun/ballistic/automatic/pistol,
/turf/closed/mineral/random/mining,
/area/ruin/unpowered/xenonest)
"r" = (
/obj/structure/alien/weeds,
/obj/structure/alien/resin/wall,
/obj/structure/alien/resin/wall,
/turf/closed/mineral/random/mining,
/area/ruin/unpowered/xenonest)
"s" = (
/obj/structure/alien/weeds,
/obj/effect/abstract/mining_landmark,
/turf/closed/mineral/random/mining,
/area/ruin/unpowered/xenonest)
"t" = (
/obj/structure/alien/weeds,
/mob/living/simple_animal/hostile/alien/sentinel,
/turf/closed/mineral/random/mining,
/area/ruin/unpowered/xenonest)
"u" = (
/obj/structure/alien/weeds,
/obj/effect/decal/cleanable/blood/gibs,
/turf/closed/mineral/random/mining,
/area/ruin/unpowered/xenonest)
"v" = (
/obj/structure/alien/weeds/node,
/obj/effect/decal/cleanable/blood,
/turf/closed/mineral/random/mining,
/area/ruin/unpowered/xenonest)
"w" = (
/obj/structure/alien/weeds,
/obj/structure/bed/nest,
/obj/structure/alien/resin/wall,
/turf/closed/mineral/random/mining,
/area/ruin/unpowered/xenonest)
"y" = (
/obj/structure/alien/weeds/node,
/obj/structure/alien/resin/wall,
/turf/closed/mineral/random/mining,
/area/ruin/unpowered/xenonest)
"z" = (
/obj/structure/alien/weeds,
/obj/structure/bed/nest,
/obj/effect/decal/cleanable/blood/gibs,
/obj/item/clothing/under/rank/security/officer,
/obj/item/clothing/suit/armor/vest,
/obj/item/melee/baton/loaded,
/obj/item/clothing/head/helmet,
/turf/closed/mineral/random/mining,
/area/ruin/unpowered/xenonest)
"B" = (
/obj/structure/alien/weeds,
/obj/structure/alien/egg/burst,
/obj/effect/decal/cleanable/blood/gibs,
/turf/closed/mineral/random/mining,
/area/ruin/unpowered/xenonest)
"C" = (
/obj/structure/alien/weeds,
/obj/structure/alien/egg/burst,
/obj/effect/decal/cleanable/blood,
/turf/closed/mineral/random/mining,
/area/ruin/unpowered/xenonest)
"E" = (
/obj/structure/alien/weeds,
/mob/living/simple_animal/hostile/alien/drone{
	plants_off = 1
	},
/turf/closed/mineral/random/mining,
/area/ruin/unpowered/xenonest)
"F" = (
/obj/structure/alien/weeds,
/mob/living/simple_animal/hostile/alien/queen/large{
	desc = "A gigantic alien who is in charge of the hive and all of its loyal servants.";
	name = "alien queen";
	pixel_x = -16;
	plants_off = 1
	},
/turf/closed/mineral/random/mining,
/area/ruin/unpowered/xenonest)
"G" = (
/turf/open/lava/smooth/lava_land_surface,
/area/mining/surface/outdoors)
"H" = (
/obj/structure/alien/weeds,
/obj/effect/decal/cleanable/blood,
/turf/closed/mineral/random/mining,
/area/ruin/unpowered/xenonest)
"I" = (
/obj/structure/alien/weeds,
/obj/structure/bed/nest,
/obj/effect/decal/cleanable/blood/gibs,
/obj/effect/decal/cleanable/blood,
/obj/item/clothing/under/syndicate,
/obj/item/clothing/glasses/night,
/turf/closed/mineral/random/mining,
/area/ruin/unpowered/xenonest)
"K" = (
/obj/structure/alien/weeds/node,
/mob/living/simple_animal/hostile/alien,
/turf/closed/mineral/random/mining,
/area/ruin/unpowered/xenonest)
"L" = (
/obj/structure/alien/weeds/node,
/mob/living/simple_animal/hostile/alien/drone{
	plants_off = 1
	},
/turf/closed/mineral/random/mining,
/area/ruin/unpowered/xenonest)
"M" = (
/obj/structure/alien/weeds,
/obj/structure/bed/nest,
/obj/effect/decal/cleanable/blood/gibs,
/obj/item/tank/internals/oxygen,
/obj/item/clothing/suit/space/syndicate/orange,
/obj/item/clothing/mask/gas,
/obj/item/clothing/head/helmet/space/syndicate/orange,
/turf/closed/mineral/random/mining,
/area/ruin/unpowered/xenonest)
"O" = (
/obj/structure/alien/weeds/node,
/turf/template_noop,
/area/ruin/unpowered/xenonest)
"Q" = (
/obj/structure/alien/weeds,
/obj/effect/decal/cleanable/blood,
/mob/living/simple_animal/hostile/alien/drone{
	plants_off = 1
	},
/turf/closed/mineral/random/mining,
/area/ruin/unpowered/xenonest)
"R" = (
/obj/structure/alien/weeds,
/turf/template_noop,
/area/ruin/unpowered/xenonest)

(1,1,1) = {"
a
a
n
G
G
G
G
G
G
G
G
G
G
n
n
n
n
a
a
a
a
a
a
a
a
a
a
a
a
a
"}
(2,1,1) = {"
a
n
n
G
b
b
b
b
b
b
b
b
G
G
n
n
n
n
a
a
a
a
a
a
a
a
a
a
a
a
"}
(3,1,1) = {"
a
n
G
G
b
g
e
e
b
g
g
b
b
G
n
n
n
n
n
a
a
a
a
a
a
a
a
a
a
a
"}
(4,1,1) = {"
a
n
G
b
b
g
g
g
g
E
g
e
b
G
n
n
n
n
n
n
a
a
a
a
a
a
a
a
a
a
"}
(5,1,1) = {"
a
n
G
b
g
g
y
b
b
b
y
b
b
G
n
n
n
n
n
n
n
n
a
a
a
a
a
a
a
a
"}
(6,1,1) = {"
n
n
G
b
g
g
w
g
F
u
I
b
b
G
n
n
n
n
n
n
n
n
n
a
a
a
a
a
a
a
"}
(7,1,1) = {"
n
n
G
b
e
t
g
g
g
H
u
g
b
G
n
n
n
n
n
n
n
n
n
n
n
a
a
a
a
a
"}
(8,1,1) = {"
n
n
G
b
i
u
b
g
l
g
t
e
b
G
n
n
n
n
n
n
n
n
n
n
n
n
n
a
a
a
"}
(9,1,1) = {"
a
n
G
b
o
v
g
b
g
g
e
b
b
G
n
n
n
n
n
n
n
n
n
n
n
n
n
n
a
a
"}
(10,1,1) = {"
a
n
G
b
g
u
b
g
g
g
y
e
b
G
n
n
n
n
n
n
n
n
n
n
n
n
n
n
a
a
"}
(11,1,1) = {"
a
n
G
b
b
g
t
g
g
t
g
g
b
G
n
n
n
n
n
n
n
n
n
n
n
b
b
b
b
a
"}
(12,1,1) = {"
a
n
G
G
b
e
g
g
g
g
g
g
b
G
n
n
n
n
n
n
n
n
n
n
b
b
M
i
b
b
"}
(13,1,1) = {"
a
n
n
G
b
b
g
g
l
g
g
b
b
G
n
n
n
n
n
n
n
n
n
b
b
e
u
Q
g
b
"}
(14,1,1) = {"
n
n
n
G
G
b
b
g
g
g
b
b
G
G
n
n
n
n
n
n
n
n
n
b
i
g
l
g
e
b
"}
(15,1,1) = {"
n
n
n
n
G
G
b
b
b
b
b
G
G
n
n
n
n
n
n
n
n
b
b
b
g
g
g
i
b
b
"}
(16,1,1) = {"
n
n
n
n
n
G
b
l
l
b
G
G
n
n
n
n
n
n
n
n
b
b
g
j
g
e
b
b
b
n
"}
(17,1,1) = {"
n
n
n
n
n
n
b
E
g
b
b
G
b
b
b
b
b
b
b
b
b
g
g
b
b
b
b
n
n
n
"}
(18,1,1) = {"
n
n
n
n
n
n
b
g
g
E
b
b
b
g
g
g
g
g
g
b
b
g
b
b
n
n
n
n
n
n
"}
(19,1,1) = {"
n
n
n
n
n
n
b
b
g
g
g
b
g
g
g
g
g
g
l
g
g
g
b
n
n
n
n
n
n
a
"}
(20,1,1) = {"
b
b
b
b
n
n
n
b
b
g
l
g
g
s
b
b
b
b
g
g
g
b
b
n
n
n
n
n
a
a
"}
(21,1,1) = {"
b
e
i
b
b
b
b
b
b
g
g
g
g
b
b
n
n
b
b
g
g
b
n
n
n
n
n
a
a
a
"}
(22,1,1) = {"
d
f
j
g
b
b
g
g
g
g
g
g
b
b
n
n
n
b
g
g
g
b
n
n
n
n
a
a
a
a
"}
(23,1,1) = {"
d
g
e
l
g
g
g
b
b
g
b
b
b
n
n
n
n
b
g
g
b
b
n
n
n
n
n
a
a
a
"}
(24,1,1) = {"
b
b
i
i
b
b
b
b
b
g
b
n
n
n
n
n
n
b
g
g
b
n
n
n
n
n
n
a
a
a
"}
(25,1,1) = {"
n
b
b
b
b
n
n
n
b
E
b
b
n
n
n
n
n
b
g
L
b
b
b
n
n
n
n
n
a
b
"}
(26,1,1) = {"
n
n
n
n
n
n
n
n
b
g
g
b
n
n
n
n
n
b
g
g
g
g
b
b
b
n
n
n
b
b
"}
(27,1,1) = {"
n
n
n
n
n
n
b
b
b
g
g
b
b
n
n
n
n
b
b
g
g
g
g
g
b
b
b
b
y
g
"}
(28,1,1) = {"
n
n
n
n
n
b
b
B
g
g
l
e
b
n
n
n
b
b
g
g
b
b
g
g
g
b
O
R
g
g
"}
(29,1,1) = {"
n
n
n
n
n
b
z
C
j
g
e
i
b
n
n
n
b
g
g
b
b
b
b
g
l
b
O
R
g
g
"}
(30,1,1) = {"
n
n
n
n
n
b
i
u
g
i
i
b
b
n
n
n
b
g
b
b
n
n
b
b
b
b
b
y
g
g
"}
(31,1,1) = {"
n
n
n
n
n
b
b
b
g
b
b
b
n
n
n
n
b
g
b
b
n
n
n
n
n
n
n
b
g
g
"}
(32,1,1) = {"
n
n
n
n
n
n
n
b
g
b
n
n
n
n
n
n
b
g
g
b
n
n
n
n
n
n
n
b
g
g
"}
(33,1,1) = {"
n
n
n
n
n
n
n
b
g
b
n
n
n
n
n
n
b
b
l
b
n
n
n
n
n
n
b
b
g
a
"}
(34,1,1) = {"
n
n
n
n
n
n
n
b
l
b
n
n
n
n
n
n
n
b
g
b
n
n
n
n
n
n
b
a
a
a
"}
(35,1,1) = {"
n
n
n
n
n
n
n
b
g
b
n
n
n
n
n
n
n
b
g
b
n
n
n
n
n
n
a
a
a
a
"}
(36,1,1) = {"
n
n
n
n
n
n
n
b
g
b
n
n
n
n
n
n
b
b
g
b
n
n
n
a
a
a
a
a
a
a
"}
(37,1,1) = {"
n
n
n
n
n
n
n
b
g
b
n
n
n
n
n
b
b
g
g
b
n
n
n
a
a
a
a
a
a
a
"}
(38,1,1) = {"
n
n
n
n
n
n
b
b
g
b
b
b
b
b
b
b
g
g
b
b
n
n
a
a
a
a
a
a
a
a
"}
(39,1,1) = {"
n
n
n
n
n
b
b
g
g
e
b
b
g
g
K
g
g
b
b
n
n
a
a
a
a
a
a
a
a
a
"}
(40,1,1) = {"
n
n
n
n
n
b
i
E
g
g
g
g
g
b
b
b
b
b
n
n
n
a
a
a
a
a
a
a
a
a
"}
(41,1,1) = {"
n
n
n
n
b
b
e
g
l
g
e
b
b
b
n
n
n
n
n
n
a
a
a
a
a
a
a
a
a
a
"}
(42,1,1) = {"
n
n
n
n
b
e
g
g
i
i
b
b
n
n
n
n
n
n
a
a
a
a
a
a
a
a
a
a
a
a
"}
(43,1,1) = {"
n
n
n
n
r
b
b
b
b
b
b
n
n
n
n
a
a
a
a
a
a
a
a
a
a
a
a
a
a
a
"}
