//MAP CONVERTED BY dmm2tgm.py THIS HEADER COMMENT PREVENTS RECONVERSION, DO NOT REMOVE
"d" = (
/turf/open/lava/smooth/lava_land_surface,
/area/mining/surface/outdoors)
"f" = (
/obj/structure/mirror{
	pixel_x = 32
	},
/obj/machinery/light/small{
	dir = 1
	},
/turf/open/floor/mineral/silver,
/area/mining/surface/outdoors)
"j" = (
/turf/open/floor/mineral/silver,
/area/mining/surface/outdoors)
"n" = (
/turf/closed/wall/mineral/diamond,
/area/mining/surface/outdoors)
"o" = (
/obj/machinery/light/small,
/turf/open/floor/mineral/silver,
/area/mining/surface/outdoors)
"r" = (
/turf/closed/mineral/random/mining,
/area/mining/surface/outdoors)
"t" = (
/obj/structure/mirror{
	pixel_x = -32
	},
/obj/machinery/light/small{
	dir = 1
	},
/turf/open/floor/mineral/silver,
/area/mining/surface/outdoors)
"v" = (
/obj/structure/mirror{
	pixel_x = 32
	},
/turf/open/floor/mineral/silver,
/area/mining/surface/outdoors)
"x" = (
/obj/effect/abstract/mining_landmark,
/turf/open/floor/mineral/silver,
/area/mining/surface/outdoors)
"y" = (
/obj/machinery/door/airlock/diamond,
/turf/open/floor/mineral/silver{
	blocks_air = 1
	},
/area/mining/surface/outdoors)
"B" = (
/obj/structure/mirror{
	pixel_x = 32
	},
/obj/machinery/light/small{
	dir = 4
	},
/turf/open/floor/mineral/silver,
/area/mining/surface/outdoors)
"F" = (
/obj/structure/mirror/magic/pride,
/turf/closed/wall/mineral/diamond,
/area/mining/surface/outdoors)
"G" = (
/obj/structure/mirror{
	pixel_x = -32
	},
/turf/open/floor/mineral/silver,
/area/mining/surface/outdoors)
"H" = (
/turf/template_noop,
/area/template_noop)
"N" = (
/turf/closed/mineral/random/mining,
/area/mining/surface/outdoors)
"O" = (
/obj/structure/mirror{
	pixel_x = -32
	},
/obj/machinery/light/small{
	brightness = 3;
	dir = 8
	},
/turf/open/floor/mineral/silver,
/area/mining/surface/outdoors)

(1,1,1) = {"
H
H
H
H
r
r
r
r
r
r
r
H
H
H
H
H
H
H
H
H
H
H
r
r
r
H
H
"}
(2,1,1) = {"
H
H
H
r
r
r
r
r
r
r
r
r
r
H
H
H
H
H
H
H
r
r
r
r
r
H
H
"}
(3,1,1) = {"
H
H
H
r
r
r
r
r
r
r
r
r
r
r
r
r
r
r
r
r
r
r
r
r
r
r
H
"}
(4,1,1) = {"
H
H
r
r
r
r
r
r
r
r
r
r
r
r
r
r
r
r
r
r
r
r
r
r
r
r
H
"}
(5,1,1) = {"
H
H
r
r
r
r
d
d
d
d
d
d
d
d
d
d
d
d
d
d
d
d
d
N
r
r
H
"}
(6,1,1) = {"
H
r
r
r
r
d
d
n
n
n
n
n
n
n
n
n
n
n
n
n
n
n
d
N
r
r
H
"}
(7,1,1) = {"
H
r
r
r
d
d
n
n
n
t
G
G
O
G
G
O
G
G
O
G
G
n
d
N
r
r
H
"}
(8,1,1) = {"
r
r
r
N
d
n
n
n
n
n
j
j
j
j
j
j
j
j
j
j
o
n
N
N
r
r
r
"}
(9,1,1) = {"
r
r
r
N
d
n
n
n
n
n
F
x
j
j
j
j
j
j
j
j
j
y
N
N
r
r
r
"}
(10,1,1) = {"
r
r
r
N
d
n
n
n
n
n
j
j
j
j
j
j
j
j
j
j
o
n
d
N
r
r
r
"}
(11,1,1) = {"
r
r
r
N
d
d
n
n
n
f
v
v
B
v
v
B
v
v
B
v
v
n
d
N
r
r
r
"}
(12,1,1) = {"
r
r
r
N
N
d
d
n
n
n
n
n
n
n
n
n
n
n
n
n
n
n
d
N
r
r
r
"}
(13,1,1) = {"
H
r
r
r
N
N
d
d
d
d
d
d
d
d
d
d
d
d
d
d
d
d
d
r
r
H
H
"}
(14,1,1) = {"
H
r
r
r
N
N
N
N
N
N
N
N
N
N
N
N
N
r
r
r
r
r
r
r
r
H
H
"}
(15,1,1) = {"
H
r
r
r
r
r
r
r
N
N
N
N
N
N
r
r
r
r
r
r
r
r
r
r
r
H
H
"}
(16,1,1) = {"
H
H
H
r
r
r
r
r
r
r
r
r
r
r
r
r
r
r
r
r
r
r
r
H
H
H
H
"}
(17,1,1) = {"
H
H
H
H
r
r
r
r
r
r
r
r
r
r
r
r
r
r
r
r
H
H
H
H
H
H
H
"}
(18,1,1) = {"
H
H
H
H
H
H
r
r
r
r
r
r
H
H
r
r
r
r
r
H
H
H
H
H
H
H
H
"}
