//MAP CONVERTED BY dmm2tgm.py THIS HEADER COMMENT PREVENTS RECONVERSION, DO NOT REMOVE
"a" = (
/turf/template_noop,
/area/mining/surface/outdoors)
"b" = (
/turf/closed/mineral/random/mining,
/area/mining/surface/outdoors)
"c" = (
/turf/closed/mineral/random/mining,
/area/mining/surface/outdoors)
"e" = (
/obj/item/clothing/shoes/workboots/mining,
/obj/item/clothing/under/rank/cargo/miner/lavaland,
/obj/effect/decal/remains/human,
/turf/closed/mineral/random/mining,
/area/mining/surface/outdoors)
"r" = (
/obj/mecha/working/ripley/mining{
	ruin_mecha = 1
	},
/obj/effect/abstract/mining_landmark,
/turf/closed/mineral/random/mining,
/area/mining/surface/outdoors)

(1,1,1) = {"
a
b
b
b
a
"}
(2,1,1) = {"
b
c
b
c
b
"}
(3,1,1) = {"
b
c
r
e
b
"}
(4,1,1) = {"
b
c
c
b
b
"}
(5,1,1) = {"
b
b
b
b
a
"}
