//MAP CONVERTED BY dmm2tgm.py THIS HEADER COMMENT PREVENTS RECONVERSION, DO NOT REMOVE
"p" = (
/obj/effect/abstract/mining_landmark,
/turf/closed/mineral/random/mining,
/area/mining/surface/outdoors)
"z" = (
/turf/template_noop,
/area/template_noop)
"C" = (
/turf/closed/mineral/random/mining,
/area/mining/surface/outdoors)

(1,1,1) = {"
z
z
z
C
C
C
C
C
C
C
C
z
z
z
z
z
"}
(2,1,1) = {"
z
z
C
C
C
C
C
C
C
C
C
C
z
z
z
z
"}
(3,1,1) = {"
z
C
C
C
C
C
C
C
C
C
C
C
z
z
z
z
"}
(4,1,1) = {"
z
C
C
C
C
C
C
C
C
C
C
C
C
C
z
z
"}
(5,1,1) = {"
z
C
C
C
C
C
C
C
C
C
C
C
C
C
C
z
"}
(6,1,1) = {"
z
C
C
C
C
C
C
C
C
C
C
C
C
C
C
z
"}
(7,1,1) = {"
C
C
C
C
C
C
C
C
C
C
C
C
C
C
C
z
"}
(8,1,1) = {"
C
C
C
C
C
C
C
C
C
C
C
C
C
C
C
z
"}
(9,1,1) = {"
C
C
C
C
C
C
C
C
C
C
C
C
C
C
C
z
"}
(10,1,1) = {"
z
C
C
C
C
C
C
C
C
C
C
C
C
C
C
z
"}
(11,1,1) = {"
C
C
C
C
C
C
C
C
C
C
C
C
C
C
C
z
"}
(12,1,1) = {"
C
C
C
C
C
C
C
C
C
C
C
C
C
C
C
C
"}
(13,1,1) = {"
C
C
C
C
C
C
C
C
C
p
C
C
C
C
C
C
"}
(14,1,1) = {"
C
C
C
C
C
C
C
C
C
C
C
C
C
C
C
C
"}
(15,1,1) = {"
C
C
C
C
C
C
C
C
C
C
C
C
C
C
C
C
"}
(16,1,1) = {"
z
C
C
C
C
C
C
C
C
C
C
C
C
C
C
C
"}
(17,1,1) = {"
C
C
C
C
C
C
C
C
C
C
C
C
C
C
C
C
"}
(18,1,1) = {"
C
C
C
C
C
C
C
C
C
C
C
C
C
C
C
C
"}
(19,1,1) = {"
C
C
C
C
C
C
C
C
C
C
C
C
C
C
C
C
"}
(20,1,1) = {"
C
C
C
C
C
C
C
C
C
C
C
C
C
C
C
C
"}
(21,1,1) = {"
C
C
C
C
C
C
C
C
C
C
C
C
C
C
C
z
"}
(22,1,1) = {"
C
C
C
C
C
C
C
C
C
C
C
C
C
C
z
z
"}
(23,1,1) = {"
C
C
C
C
C
C
C
C
C
C
C
C
C
C
C
z
"}
(24,1,1) = {"
z
C
C
C
C
C
C
C
C
C
C
C
C
z
z
z
"}
(25,1,1) = {"
z
C
z
C
C
C
C
C
C
C
C
C
C
z
z
z
"}
(26,1,1) = {"
z
z
z
z
C
C
C
C
C
C
C
C
z
z
z
z
"}
(27,1,1) = {"
z
z
z
z
C
C
z
C
C
C
C
z
z
z
z
z
"}
(28,1,1) = {"
z
z
z
z
z
z
z
C
z
z
z
z
z
z
z
z
"}
