//MAP CONVERTED BY dmm2tgm.py THIS HEADER COMMENT PREVENTS RECONVERSION, DO NOT REMOVE
"g" = (
/obj/effect/abstract/mining_landmark,
/turf/closed/mineral/random/mining,
/area/mining/surface/outdoors)
"D" = (
/turf/closed/mineral/random/mining,
/area/mining/surface/outdoors)
"G" = (
/turf/template_noop,
/area/template_noop)

(1,1,1) = {"
G
G
D
D
D
D
D
D
D
G
G
G
G
G
G
"}
(2,1,1) = {"
G
D
D
D
D
D
D
D
D
G
G
G
G
G
G
"}
(3,1,1) = {"
G
D
D
D
D
D
D
D
D
G
G
G
G
G
G
"}
(4,1,1) = {"
D
D
D
D
D
D
D
D
D
D
G
G
D
G
G
"}
(5,1,1) = {"
D
D
D
D
D
D
D
D
D
D
D
D
D
G
G
"}
(6,1,1) = {"
D
D
D
D
D
D
D
D
D
D
D
D
D
D
D
"}
(7,1,1) = {"
D
D
D
D
D
D
D
D
D
D
D
D
D
D
D
"}
(8,1,1) = {"
D
D
D
D
D
D
D
D
D
D
D
D
D
D
D
"}
(9,1,1) = {"
G
D
D
D
D
D
D
D
D
D
D
D
D
D
D
"}
(10,1,1) = {"
G
D
D
D
D
D
D
D
D
D
D
D
D
D
D
"}
(11,1,1) = {"
G
G
D
D
D
D
g
D
D
D
D
D
D
D
D
"}
(12,1,1) = {"
G
D
D
D
D
D
D
D
D
D
D
D
D
D
D
"}
(13,1,1) = {"
G
D
D
D
D
D
D
D
D
D
D
D
D
D
G
"}
(14,1,1) = {"
G
D
D
D
D
D
D
D
D
D
D
D
D
G
G
"}
(15,1,1) = {"
G
D
D
D
D
D
D
D
D
D
D
D
D
G
G
"}
(16,1,1) = {"
G
D
D
D
D
D
D
D
D
D
D
D
G
G
G
"}
(17,1,1) = {"
D
D
D
D
D
D
D
D
D
D
D
D
G
G
G
"}
(18,1,1) = {"
D
D
D
D
D
D
D
D
D
D
D
D
G
G
G
"}
(19,1,1) = {"
D
D
D
D
D
D
D
D
D
D
D
D
D
G
G
"}
(20,1,1) = {"
D
D
D
D
D
D
D
D
D
D
D
D
D
D
G
"}
(21,1,1) = {"
G
G
D
D
D
D
D
D
D
D
D
D
D
D
G
"}
(22,1,1) = {"
G
G
G
G
G
D
D
D
D
D
D
D
D
D
G
"}
(23,1,1) = {"
G
G
G
G
G
G
D
D
D
D
D
D
D
D
G
"}
(24,1,1) = {"
G
G
G
G
G
G
G
D
D
D
D
D
D
G
G
"}
