//MAP CONVERTED BY dmm2tgm.py THIS HEADER COMMENT PREVENTS RECONVERSION, DO NOT REMOVE
"l" = (
/obj/effect/abstract/mining_landmark,
/turf/closed/mineral/random/mining,
/area/mining/surface/outdoors)
"M" = (
/turf/template_noop,
/area/template_noop)
"Y" = (
/turf/closed/mineral/random/mining,
/area/mining/surface/outdoors)

(1,1,1) = {"
M
M
M
M
M
M
Y
M
Y
Y
M
M
M
M
M
M
M
M
"}
(2,1,1) = {"
M
M
M
M
M
M
Y
Y
Y
Y
Y
M
M
M
M
M
M
M
"}
(3,1,1) = {"
M
M
M
M
M
Y
Y
Y
Y
Y
Y
M
M
M
M
M
M
M
"}
(4,1,1) = {"
M
M
M
M
M
Y
Y
Y
Y
Y
Y
Y
Y
M
M
M
M
M
"}
(5,1,1) = {"
M
M
M
Y
Y
Y
Y
Y
Y
Y
Y
Y
Y
Y
M
M
M
M
"}
(6,1,1) = {"
M
M
Y
Y
Y
Y
Y
Y
Y
Y
Y
Y
Y
Y
Y
M
M
M
"}
(7,1,1) = {"
Y
Y
Y
Y
Y
Y
Y
Y
l
Y
Y
Y
Y
Y
Y
Y
M
M
"}
(8,1,1) = {"
Y
Y
Y
Y
Y
Y
Y
Y
Y
Y
Y
Y
Y
Y
Y
Y
Y
Y
"}
(9,1,1) = {"
Y
Y
M
M
M
Y
Y
Y
Y
Y
Y
Y
Y
Y
Y
Y
Y
M
"}
(10,1,1) = {"
M
M
M
M
Y
Y
Y
Y
Y
Y
Y
Y
Y
Y
Y
Y
Y
Y
"}
(11,1,1) = {"
M
M
M
M
Y
Y
Y
Y
Y
Y
Y
Y
Y
Y
Y
Y
M
M
"}
(12,1,1) = {"
M
M
M
M
M
Y
Y
M
Y
Y
Y
Y
Y
Y
Y
M
M
M
"}
