//MAP CONVERTED BY dmm2tgm.py THIS HEADER COMMENT PREVENTS RECONVERSION, DO NOT REMOVE
"q" = (
/turf/template_noop,
/area/template_noop)
"x" = (
/obj/effect/abstract/mining_landmark,
/turf/closed/mineral/random/mining,
/area/mining/surface/outdoors)
"Y" = (
/turf/closed/mineral/random/mining,
/area/mining/surface/outdoors)

(1,1,1) = {"
q
q
Y
Y
Y
Y
Y
q
q
"}
(2,1,1) = {"
q
Y
Y
Y
Y
Y
Y
q
q
"}
(3,1,1) = {"
q
Y
Y
Y
Y
Y
Y
Y
q
"}
(4,1,1) = {"
Y
Y
Y
Y
Y
Y
Y
Y
q
"}
(5,1,1) = {"
Y
Y
Y
Y
Y
Y
Y
Y
q
"}
(6,1,1) = {"
Y
Y
Y
Y
Y
Y
Y
Y
Y
"}
(7,1,1) = {"
Y
Y
Y
Y
Y
Y
Y
Y
Y
"}
(8,1,1) = {"
Y
Y
Y
Y
Y
Y
Y
Y
Y
"}
(9,1,1) = {"
Y
Y
Y
Y
Y
Y
Y
Y
Y
"}
(10,1,1) = {"
Y
Y
Y
Y
Y
x
Y
Y
Y
"}
(11,1,1) = {"
Y
Y
Y
Y
Y
Y
Y
Y
Y
"}
(12,1,1) = {"
q
q
Y
Y
Y
Y
Y
Y
Y
"}
(13,1,1) = {"
q
q
Y
Y
Y
Y
Y
Y
Y
"}
(14,1,1) = {"
q
q
q
Y
Y
Y
Y
Y
Y
"}
(15,1,1) = {"
q
q
q
Y
Y
Y
Y
Y
Y
"}
(16,1,1) = {"
q
q
q
Y
Y
Y
Y
Y
Y
"}
(17,1,1) = {"
q
q
q
q
Y
Y
Y
Y
Y
"}
(18,1,1) = {"
q
q
q
q
Y
Y
Y
Y
Y
"}
(19,1,1) = {"
q
q
q
q
Y
Y
Y
Y
q
"}
(20,1,1) = {"
q
q
q
q
Y
Y
Y
Y
q
"}
(21,1,1) = {"
q
q
q
q
Y
Y
Y
Y
q
"}
(22,1,1) = {"
q
q
q
q
Y
Y
Y
q
q
"}
(23,1,1) = {"
q
q
q
Y
Y
Y
q
q
q
"}
