//MAP CONVERTED BY dmm2tgm.py THIS HEADER COMMENT PREVENTS RECONVERSION, DO NOT REMOVE
"z" = (
/turf/closed/mineral/random/mining,
/area/mining/surface/outdoors)
"P" = (
/turf/template_noop,
/area/template_noop)
"T" = (
/obj/effect/abstract/mining_landmark,
/turf/closed/mineral/random/mining,
/area/mining/surface/outdoors)

(1,1,1) = {"
P
P
P
P
P
P
z
z
z
z
P
P
P
P
"}
(2,1,1) = {"
P
P
P
P
P
z
z
z
z
z
z
P
P
P
"}
(3,1,1) = {"
P
P
P
P
z
z
z
z
z
z
z
z
P
P
"}
(4,1,1) = {"
P
P
P
z
z
z
z
z
z
z
z
z
z
z
"}
(5,1,1) = {"
P
z
z
z
z
z
z
z
z
z
z
z
z
z
"}
(6,1,1) = {"
z
z
z
z
z
z
z
z
z
z
z
z
z
z
"}
(7,1,1) = {"
z
z
z
z
z
z
z
z
z
z
z
z
z
P
"}
(8,1,1) = {"
z
z
z
z
z
z
z
z
z
z
z
z
P
P
"}
(9,1,1) = {"
z
z
z
z
z
z
T
z
z
z
z
z
P
P
"}
(10,1,1) = {"
P
z
z
z
z
z
z
z
z
z
z
z
P
P
"}
(11,1,1) = {"
z
z
z
z
z
z
z
z
z
z
z
P
P
P
"}
(12,1,1) = {"
z
z
z
z
z
z
z
z
z
z
z
P
P
P
"}
(13,1,1) = {"
P
z
z
z
z
z
z
z
z
z
P
P
P
P
"}
(14,1,1) = {"
P
P
z
z
z
z
z
z
z
z
P
P
P
P
"}
(15,1,1) = {"
P
P
z
z
z
z
z
z
z
z
P
P
P
P
"}
(16,1,1) = {"
P
z
z
z
z
z
z
P
z
z
P
P
P
P
"}
(17,1,1) = {"
P
P
z
z
z
P
P
P
z
P
P
P
P
P
"}
