//MAP CONVERTED BY dmm2tgm.py THIS HEADER COMMENT PREVENTS RECONVERSION, DO NOT REMOVE
"a" = (
/turf/template_noop,
/area/template_noop)
"b" = (
/turf/closed/wall/mineral/plastitanium,
/area/shuttle/transport)
"c" = (
/turf/closed/wall/mineral/titanium/nodiagonal,
/area/shuttle/transport)
"d" = (
/turf/closed/wall/mineral/titanium,
/area/shuttle/transport)
"e" = (
/obj/effect/spawner/structure/window/shuttle,
/turf/open/floor/plating,
/area/shuttle/transport)
"f" = (
/obj/machinery/door/airlock/shuttle{
	name = "Ferry Shuttle Airlock"
	},
/obj/effect/turf_decal/stripes/line,
/obj/effect/turf_decal/stripes/line{
	dir = 1
	},
/obj/structure/fans/tiny,
/turf/open/floor/mineral/plastitanium,
/area/shuttle/transport)
"g" = (
/obj/structure/sign/nanotrasen,
/turf/closed/wall/mineral/titanium,
/area/shuttle/transport)
"j" = (
/obj/structure/sign/warning/fire,
/turf/closed/wall/mineral/titanium/nodiagonal,
/area/shuttle/transport)
"k" = (
/obj/structure/table/reinforced,
/obj/item/storage/firstaid/o2{
	pixel_x = 4;
	pixel_y = 4
	},
/obj/item/storage/firstaid/regular,
/obj/item/crowbar,
/obj/machinery/light{
	dir = 8
	},
/turf/open/floor/mineral/plastitanium,
/area/shuttle/transport)
"l" = (
/obj/effect/turf_decal/bot,
/obj/structure/chair/fancy/shuttle,
/turf/open/floor/mineral/plastitanium,
/area/shuttle/transport)
"n" = (
/obj/structure/table/reinforced,
/obj/machinery/recharger,
/turf/open/floor/mineral/plastitanium,
/area/shuttle/transport)
"w" = (
/obj/effect/turf_decal/bot,
/obj/structure/chair/fancy/shuttle{
	dir = 1
	},
/turf/open/floor/mineral/plastitanium,
/area/shuttle/transport)
"z" = (
/obj/structure/window/shuttle,
/obj/structure/grille,
/obj/machinery/power/engine_capacitor_bank{
	dir = 4
	},
/obj/structure/cable/yellow,
/turf/open/floor/plating,
/area/shuttle/transport)
"A" = (
/obj/effect/turf_decal/bot,
/obj/machinery/light{
	dir = 1
	},
/obj/structure/chair/fancy/shuttle,
/turf/open/floor/mineral/plastitanium,
/area/shuttle/transport)
"B" = (
/obj/structure/cable/yellow{
	icon_state = "4-8"
	},
/obj/effect/turf_decal/stripes/line{
	dir = 1
	},
/obj/effect/turf_decal/stripes/line,
/obj/effect/turf_decal/tile/neutral/opposingcorners,
/turf/open/floor/mineral/plastitanium,
/area/shuttle/transport)
"G" = (
/obj/structure/window/shuttle,
/obj/structure/grille,
/obj/machinery/power/engine_capacitor_bank{
	dir = 4
	},
/obj/structure/cable/yellow{
	icon_state = "2-4"
	},
/obj/structure/cable/yellow{
	icon_state = "0-2"
	},
/obj/structure/cable/yellow{
	icon_state = "1-4"
	},
/turf/open/floor/plating,
/area/shuttle/transport)
"J" = (
/obj/structure/window/shuttle,
/obj/structure/grille,
/obj/machinery/power/engine_capacitor_bank{
	dir = 4
	},
/obj/structure/cable/yellow{
	icon_state = "0-2"
	},
/turf/open/floor/plating,
/area/shuttle/transport)
"L" = (
/obj/structure/chair/fancy/shuttle{
	dir = 8
	},
/obj/effect/turf_decal/stripes/line{
	dir = 1
	},
/obj/effect/turf_decal/stripes/line,
/obj/effect/turf_decal/tile/neutral/opposingcorners,
/obj/structure/cable/yellow{
	icon_state = "4-8"
	},
/turf/open/floor/mineral/plastitanium,
/area/shuttle/transport)
"O" = (
/obj/structure/cable/yellow{
	icon_state = "2-8"
	},
/obj/effect/turf_decal/stripes/line{
	dir = 1
	},
/obj/effect/turf_decal/stripes/line,
/obj/effect/turf_decal/tile/neutral/opposingcorners,
/turf/open/floor/mineral/plastitanium,
/area/shuttle/transport)
"Q" = (
/obj/machinery/computer/shuttle_flight/ferry/request{
	dir = 4
	},
/obj/effect/turf_decal/bot,
/obj/effect/turf_decal/stripes/line{
	dir = 4
	},
/obj/structure/cable/yellow{
	icon_state = "4-8"
	},
/turf/open/floor/mineral/plastitanium,
/area/shuttle/transport)
"S" = (
/obj/effect/turf_decal/stripes/line{
	dir = 8
	},
/obj/effect/turf_decal/stripes/line{
	dir = 4
	},
/obj/effect/turf_decal/tile/neutral/opposingcorners,
/turf/open/floor/mineral/plastitanium,
/area/shuttle/transport)
"V" = (
/obj/effect/turf_decal/bot,
/obj/machinery/light,
/obj/machinery/power/smes/engineering{
	charge = 5e+006
	},
/obj/structure/cable/yellow,
/turf/open/floor/plating,
/area/shuttle/transport)
"W" = (
/obj/effect/turf_decal/stripes/line{
	dir = 8
	},
/obj/machinery/shuttle/engine/ion/burst{
	dir = 4
	},
/turf/open/floor/plating/airless,
/area/shuttle/transport)
"X" = (
/obj/structure/cable/yellow{
	icon_state = "4-8"
	},
/obj/effect/turf_decal/stripes/corner,
/obj/effect/turf_decal/stripes/corner{
	dir = 1
	},
/obj/effect/turf_decal/stripes/corner{
	dir = 4
	},
/obj/effect/turf_decal/stripes/corner{
	dir = 8
	},
/obj/effect/turf_decal/tile/neutral/opposingcorners,
/turf/open/floor/mineral/plastitanium,
/area/shuttle/transport)
"Y" = (
/obj/structure/rack,
/obj/effect/turf_decal/bot,
/obj/item/radio{
	pixel_x = -6;
	pixel_y = 6
	},
/obj/item/radio{
	pixel_x = 6;
	pixel_y = 6
	},
/obj/item/radio{
	pixel_y = 4
	},
/obj/machinery/light{
	dir = 8
	},
/obj/effect/turf_decal/tile/neutral/half/contrasted{
	dir = 4
	},
/turf/open/floor/mineral/plastitanium,
/area/shuttle/transport)
"Z" = (
/obj/machinery/door/airlock/shuttle{
	name = "Ferry Shuttle Airlock"
	},
/obj/effect/turf_decal/stripes/line{
	dir = 4
	},
/obj/effect/turf_decal/stripes/line{
	dir = 8
	},
/obj/structure/fans/tiny,
/obj/docking_port/mobile{
	dir = 8;
	dwidth = 2;
	faction_type = /datum/faction/nanotrasen/central_command;
	height = 11;
	id = "ferry";
	name = "ferry shuttle";
	preferred_direction = 4;
	width = 5
	},
/turf/open/floor/mineral/plastitanium,
/area/shuttle/transport)

(1,1,1) = {"
a
W
W
W
a
"}
(2,1,1) = {"
b
J
G
z
b
"}
(3,1,1) = {"
c
j
Q
j
c
"}
(4,1,1) = {"
d
k
L
Y
d
"}
(5,1,1) = {"
e
l
B
w
e
"}
(6,1,1) = {"
d
l
B
w
d
"}
(7,1,1) = {"
f
S
X
S
f
"}
(8,1,1) = {"
g
n
B
n
g
"}
(9,1,1) = {"
e
l
B
w
e
"}
(10,1,1) = {"
d
A
O
V
d
"}
(11,1,1) = {"
d
e
Z
e
d
"}
