//MAP CONVERTED BY dmm2tgm.py THIS HEADER COMMENT PREVENTS RECONVERSION, DO NOT REMOVE
"a" = (
/turf/closed/wall/mineral/titanium,
/area/shuttle/mining)
"b" = (
/obj/effect/spawner/structure/window/shuttle,
/turf/open/floor/plating,
/area/shuttle/mining)
"e" = (
/obj/structure/table,
/obj/item/crowbar/red,
/obj/item/radio/intercom{
	pixel_y = 22
	},
/obj/machinery/light/small{
	dir = 4
	},
/turf/open/floor/mineral/plastitanium,
/area/shuttle/mining)
"g" = (
/obj/effect/turf_decal/bot,
/obj/structure/chair/fancy/shuttle{
	dir = 1
	},
/turf/open/floor/mineral/plastitanium,
/area/shuttle/mining)
"k" = (
/obj/item/clothing/suit/hazardvest{
	desc = "A high-visibility lifejacket complete with whistle and slot for oxygen tanks.";
	name = "emergency lifejacket"
	},
/obj/item/clothing/suit/hazardvest{
	desc = "A high-visibility lifejacket complete with whistle and slot for oxygen tanks.";
	name = "emergency lifejacket"
	},
/obj/item/tank/internals/emergency_oxygen{
	pixel_x = 3
	},
/obj/item/tank/internals/emergency_oxygen{
	pixel_x = 3
	},
/obj/item/clothing/mask/breath{
	pixel_x = -3;
	pixel_y = -3
	},
/obj/item/clothing/mask/breath{
	pixel_x = -3;
	pixel_y = -3
	},
/obj/item/clothing/head/hardhat/orange{
	name = "protective hat";
	pixel_y = 9
	},
/obj/item/clothing/head/hardhat/orange{
	name = "protective hat";
	pixel_y = 9
	},
/obj/structure/closet/crate/internals,
/obj/machinery/airalarm{
	dir = 4;
	pixel_x = -22
	},
/obj/machinery/light/small,
/obj/effect/turf_decal/box,
/turf/open/floor/mineral/plastitanium,
/area/shuttle/mining)
"m" = (
/obj/structure/ore_box,
/obj/machinery/light/small,
/obj/effect/turf_decal/box,
/turf/open/floor/mineral/plastitanium,
/area/shuttle/mining)
"n" = (
/obj/structure/sign/warning/fire,
/turf/closed/wall/mineral/titanium,
/area/shuttle/mining)
"p" = (
/obj/effect/turf_decal/bot,
/obj/machinery/computer/shuttle_flight/mining,
/obj/structure/cable/yellow{
	icon_state = "2-8"
	},
/turf/open/floor/mineral/plastitanium,
/area/shuttle/mining)
"r" = (
/obj/machinery/door/airlock/shuttle{
	name = "Mining Shuttle Airlock"
	},
/obj/effect/turf_decal/stripes/line{
	dir = 8
	},
/obj/effect/turf_decal/stripes/line{
	dir = 4
	},
/obj/docking_port/mobile{
	dir = 8;
	dwidth = 3;
	faction_type = /datum/faction/station;
	height = 5;
	id = "mining";
	name = "mining shuttle";
	port_direction = 4;
	width = 7
	},
/obj/machinery/atmospherics/pipe/simple/general/hidden{
	dir = 8
	},
/obj/structure/fans/tiny,
/obj/structure/cable{
	icon_state = "4-8"
	},
/turf/open/floor/mineral/plastitanium,
/area/shuttle/mining)
"x" = (
/obj/machinery/atmospherics/components/unary/vent_pump/on{
	dir = 4
	},
/obj/structure/cable/yellow{
	icon_state = "1-2"
	},
/obj/structure/cable{
	icon_state = "4-8"
	},
/obj/effect/turf_decal/stripes/line,
/obj/effect/turf_decal/tile/brown/opposingcorners,
/turf/open/floor/mineral/titanium/yellow,
/area/shuttle/mining)
"z" = (
/obj/structure/cable{
	icon_state = "1-4"
	},
/obj/machinery/status_display/evac{
	pixel_x = -32
	},
/obj/effect/turf_decal/stripes/line{
	dir = 10
	},
/obj/effect/turf_decal/tile/brown/opposingcorners,
/turf/open/floor/mineral/titanium/yellow,
/area/shuttle/mining)
"A" = (
/obj/machinery/light/small{
	dir = 8
	},
/obj/machinery/power/smes{
	charge = 1e+006
	},
/obj/structure/cable/yellow{
	icon_state = "0-4"
	},
/turf/open/floor/mineral/plastitanium,
/area/shuttle/mining)
"D" = (
/obj/effect/turf_decal/stripes/line{
	dir = 5
	},
/obj/effect/turf_decal/tile/brown/opposingcorners,
/turf/open/floor/mineral/titanium/yellow,
/area/shuttle/mining)
"H" = (
/obj/effect/turf_decal/bot,
/obj/structure/chair/fancy/shuttle{
	dir = 1
	},
/obj/structure/cable/yellow{
	icon_state = "1-2"
	},
/turf/open/floor/mineral/plastitanium,
/area/shuttle/mining)
"I" = (
/obj/structure/cable{
	icon_state = "0-2"
	},
/obj/machinery/power/terminal{
	dir = 1
	},
/obj/effect/turf_decal/stripes/line{
	dir = 9
	},
/obj/effect/turf_decal/tile/brown/opposingcorners,
/turf/open/floor/mineral/titanium/yellow,
/area/shuttle/mining)
"K" = (
/obj/structure/cable/yellow{
	icon_state = "1-2"
	},
/obj/effect/turf_decal/stripes/line{
	dir = 1
	},
/obj/structure/chair/fancy/shuttle{
	dir = 1
	},
/obj/effect/turf_decal/tile/brown/opposingcorners,
/turf/open/floor/mineral/titanium/yellow,
/area/shuttle/mining)
"O" = (
/obj/effect/spawner/structure/window/shuttle,
/obj/machinery/power/engine_capacitor_bank{
	dir = 1
	},
/obj/structure/cable/yellow,
/turf/open/floor/plating,
/area/shuttle/mining)
"V" = (
/obj/effect/turf_decal/stripes/line,
/obj/machinery/shuttle/engine/ion/burst{
	dir = 1
	},
/turf/open/floor/plating/airless,
/area/shuttle/mining)
"Z" = (
/obj/machinery/atmospherics/pipe/simple/general/hidden{
	dir = 8
	},
/obj/structure/cable{
	icon_state = "4-8"
	},
/obj/effect/turf_decal/stripes/line,
/obj/effect/turf_decal/stripes/corner{
	dir = 4
	},
/obj/effect/turf_decal/tile/brown/opposingcorners,
/turf/open/floor/mineral/titanium/yellow,
/area/shuttle/mining)

(1,1,1) = {"
a
a
b
a
b
a
a
"}
(2,1,1) = {"
a
A
I
z
g
k
n
"}
(3,1,1) = {"
b
p
K
x
H
O
V
"}
(4,1,1) = {"
a
e
D
Z
g
m
n
"}
(5,1,1) = {"
a
a
b
r
b
a
a
"}
