//MAP CONVERTED BY dmm2tgm.py THIS HEADER COMMENT PREVENTS RECONVERSION, DO NOT REMOVE
"a" = (
/turf/closed/wall/mineral/titanium/survival,
/area/shuttle/mining)
"b" = (
/obj/effect/spawner/structure/window/hollow/survival_pod/directional{
	dir = 1
	},
/turf/open/floor/plating,
/area/shuttle/mining)
"c" = (
/obj/structure/table/reinforced,
/obj/item/storage/toolbox/emergency,
/obj/effect/turf_decal/stripes/line{
	dir = 9
	},
/obj/machinery/light/small{
	dir = 8
	},
/turf/open/floor/pod/dark,
/area/shuttle/mining)
"d" = (
/obj/machinery/computer/shuttle_flight/mining,
/obj/effect/decal/cleanable/dirt,
/obj/effect/turf_decal/stripes/line{
	dir = 1
	},
/turf/open/floor/pod/dark,
/area/shuttle/mining)
"e" = (
/obj/structure/table/reinforced,
/obj/effect/decal/cleanable/dirt,
/obj/item/crowbar/red,
/obj/item/wrench,
/obj/item/tank/internals/emergency_oxygen,
/obj/item/clothing/mask/gas,
/obj/effect/turf_decal/stripes/line{
	dir = 5
	},
/obj/machinery/light/small{
	dir = 4
	},
/turf/open/floor/pod/dark,
/area/shuttle/mining)
"f" = (
/obj/effect/turf_decal/stripes/line{
	dir = 8
	},
/turf/open/floor/pod/dark,
/area/shuttle/mining)
"h" = (
/obj/effect/decal/cleanable/dirt,
/obj/effect/decal/cleanable/blood/old,
/obj/effect/turf_decal/stripes/line{
	dir = 4
	},
/turf/open/floor/pod/dark,
/area/shuttle/mining)
"s" = (
/obj/structure/ore_box,
/obj/effect/decal/cleanable/dirt,
/obj/effect/turf_decal/delivery,
/obj/machinery/light/small{
	dir = 4
	},
/turf/open/floor/pod/dark,
/area/shuttle/mining)
"A" = (
/obj/effect/turf_decal/stripes/line{
	dir = 8
	},
/obj/effect/turf_decal/stripes/line{
	dir = 4
	},
/obj/docking_port/mobile{
	dir = 4;
	dwidth = 3;
	faction_type = /datum/faction/station;
	height = 5;
	id = "mining";
	name = "mining shuttle";
	port_direction = 8;
	width = 7
	},
/obj/effect/mapping_helpers/airlock/cyclelink_helper{
	dir = 4
	},
/obj/machinery/door/airlock/survival_pod/glass,
/obj/structure/fans/tiny,
/obj/structure/cable{
	icon_state = "4-8"
	},
/turf/open/floor/pod/light,
/area/shuttle/mining)
"B" = (
/obj/effect/turf_decal/stripes/line{
	dir = 4
	},
/obj/structure/cable{
	icon_state = "4-8"
	},
/turf/open/floor/pod/dark,
/area/shuttle/mining)
"D" = (
/obj/structure/window/reinforced{
	dir = 4
	},
/obj/structure/window/reinforced{
	dir = 1
	},
/obj/structure/window/reinforced{
	dir = 8
	},
/obj/effect/turf_decal/stripes/line,
/obj/machinery/power/engine_capacitor_bank{
	dir = 1
	},
/obj/structure/cable{
	icon_state = "0-8"
	},
/turf/open/floor/plating,
/area/shuttle/mining)
"F" = (
/obj/machinery/light/small{
	dir = 8
	},
/obj/machinery/power/smes{
	charge = 1e+006
	},
/obj/structure/cable{
	icon_state = "0-4"
	},
/turf/open/floor/plating,
/area/shuttle/mining)
"G" = (
/obj/effect/decal/cleanable/dirt,
/obj/effect/turf_decal/stripes/line{
	dir = 8
	},
/obj/structure/cable{
	icon_state = "2-8"
	},
/obj/structure/cable{
	icon_state = "2-4"
	},
/turf/open/floor/pod/dark,
/area/shuttle/mining)
"J" = (
/obj/effect/spawner/structure/window/hollow/survival_pod/directional{
	dir = 4
	},
/turf/open/floor/plating,
/area/shuttle/mining)
"K" = (
/obj/effect/decal/cleanable/dirt,
/obj/effect/turf_decal/stripes/end{
	dir = 8
	},
/obj/machinery/power/terminal,
/obj/structure/cable,
/obj/structure/chair/fancy/shuttle{
	dir = 1
	},
/turf/open/floor/pod/dark,
/area/shuttle/mining)
"M" = (
/obj/structure/window/reinforced{
	dir = 1;
	layer = 2.9
	},
/obj/effect/turf_decal/stripes/line,
/obj/machinery/shuttle/engine/ion/burst{
	dir = 1
	},
/turf/open/floor/plating/airless,
/area/shuttle/mining)
"O" = (
/obj/structure/cable{
	icon_state = "4-8"
	},
/obj/effect/turf_decal/tile/neutral/fourcorners/contrasted,
/turf/open/floor/pod/dark,
/area/shuttle/mining)
"Q" = (
/obj/effect/spawner/structure/window/hollow/survival_pod/directional{
	dir = 8
	},
/turf/open/floor/plating,
/area/shuttle/mining)
"R" = (
/obj/structure/chair/fancy/shuttle{
	dir = 1
	},
/obj/effect/turf_decal/tile/neutral/fourcorners/contrasted,
/turf/open/floor/pod/dark,
/area/shuttle/mining)
"S" = (
/turf/closed/wall/mineral/titanium/survival/nodiagonal,
/area/shuttle/mining)
"V" = (
/obj/effect/decal/cleanable/dirt,
/obj/effect/turf_decal/stripes/end{
	dir = 4
	},
/obj/structure/closet/crate/internals,
/obj/item/pickaxe/emergency,
/obj/item/pickaxe/emergency,
/obj/item/clothing/mask/breath{
	pixel_x = -3;
	pixel_y = -3
	},
/obj/item/clothing/mask/breath{
	pixel_x = -3;
	pixel_y = -3
	},
/obj/item/clothing/mask/breath{
	pixel_x = -3;
	pixel_y = -3
	},
/obj/item/clothing/mask/breath{
	pixel_x = -3;
	pixel_y = -3
	},
/obj/item/tank/internals/emergency_oxygen{
	pixel_x = 3
	},
/obj/item/tank/internals/emergency_oxygen{
	pixel_x = 3
	},
/obj/item/tank/internals/emergency_oxygen{
	pixel_x = 3
	},
/obj/item/tank/internals/emergency_oxygen{
	pixel_x = 3
	},
/obj/item/clothing/suit/hazardvest{
	desc = "A high-visibility lifejacket complete with whistle and slot for oxygen tanks.";
	name = "emergency lifejacket"
	},
/obj/item/clothing/suit/hazardvest{
	desc = "A high-visibility lifejacket complete with whistle and slot for oxygen tanks.";
	name = "emergency lifejacket"
	},
/obj/item/clothing/suit/hazardvest{
	desc = "A high-visibility lifejacket complete with whistle and slot for oxygen tanks.";
	name = "emergency lifejacket"
	},
/obj/item/clothing/suit/hazardvest{
	desc = "A high-visibility lifejacket complete with whistle and slot for oxygen tanks.";
	name = "emergency lifejacket"
	},
/obj/item/clothing/head/hardhat/orange{
	name = "protective hat";
	pixel_y = 9
	},
/obj/item/clothing/head/hardhat/orange{
	name = "protective hat";
	pixel_y = 9
	},
/obj/item/clothing/head/hardhat/orange{
	name = "protective hat";
	pixel_y = 9
	},
/obj/item/clothing/head/hardhat/orange{
	name = "protective hat";
	pixel_y = 9
	},
/turf/open/floor/pod/dark,
/area/shuttle/mining)
"X" = (
/obj/effect/turf_decal/stripes/line{
	dir = 8
	},
/obj/effect/turf_decal/stripes/line{
	dir = 4
	},
/obj/effect/mapping_helpers/airlock/cyclelink_helper{
	dir = 8
	},
/obj/machinery/door/airlock/survival_pod/glass,
/obj/structure/fans/tiny,
/obj/structure/cable{
	icon_state = "4-8"
	},
/turf/open/floor/pod/light,
/area/shuttle/mining)
"Z" = (
/obj/effect/decal/cleanable/dirt,
/obj/effect/turf_decal/stripes/line,
/obj/effect/turf_decal/stripes/line{
	dir = 1
	},
/obj/structure/chair/fancy/shuttle{
	dir = 1
	},
/turf/open/floor/pod/dark,
/area/shuttle/mining)

(1,1,1) = {"
a
S
Q
A
Q
S
a
"}
(2,1,1) = {"
S
c
f
G
K
F
S
"}
(3,1,1) = {"
b
d
R
O
Z
D
M
"}
(4,1,1) = {"
S
e
h
B
V
s
S
"}
(5,1,1) = {"
a
S
J
X
J
S
a
"}
