//MAP CONVERTED BY dmm2tgm.py THIS HEADER COMMENT PREVENTS RECONVERSION, DO NOT REMOVE
"aa" = (
/obj/machinery/door/airlock/shuttle,
/obj/effect/turf_decal/stripes/line,
/obj/effect/turf_decal/stripes/line{
	dir = 1
	},
/obj/machinery/door/firedoor/border_only,
/obj/machinery/door/firedoor/border_only{
	dir = 1
	},
/turf/open/floor/mineral/titanium,
/area/shuttle/exploration)
"ab" = (
/obj/effect/turf_decal/delivery,
/obj/machinery/atmospherics/pipe/manifold/purple/visible{
	dir = 1
	},
/obj/structure/closet/crate,
/obj/item/radio/headset/headset_exploration,
/obj/item/radio/headset/headset_exploration,
/obj/item/wrench,
/obj/item/pickaxe,
/obj/item/mining_scanner,
/turf/open/floor/mineral/titanium,
/area/shuttle/exploration)
"ac" = (
/obj/machinery/atmospherics/components/binary/dp_vent_pump{
	dir = 8
	},
/turf/open/floor/mineral/plastitanium,
/area/shuttle/exploration)
"ad" = (
/turf/open/floor/mineral/plastitanium,
/area/shuttle/exploration)
"ae" = (
/obj/structure/fans/tiny,
/obj/effect/turf_decal/stripes/line{
	dir = 8
	},
/obj/effect/turf_decal/stripes/line{
	dir = 4
	},
/obj/machinery/door/poddoor/shutters{
	id = "exploration"
	},
/obj/machinery/button/door{
	desc = "A remote control switch.";
	id = "exploration";
	name = "Exploration Shuttle Shutters";
	pixel_y = 24
	},
/turf/open/floor/mineral/titanium,
/area/shuttle/exploration)
"af" = (
/obj/machinery/atmospherics/pipe/simple/dark/hidden{
	dir = 4
	},
/turf/closed/wall/mineral/titanium/nodiagonal,
/area/shuttle/exploration)
"ag" = (
/turf/open/floor/mineral/titanium,
/area/shuttle/exploration)
"ah" = (
/obj/machinery/door/airlock/external/glass,
/obj/machinery/atmospherics/pipe/simple/dark/hidden{
	dir = 6
	},
/obj/docking_port/mobile{
	dir = 4;
	dwidth = 5;
	faction_type = /datum/faction/station;
	height = 7;
	id = "exploration";
	name = "Exploration Shuttle";
	port_direction = 8;
	shuttle_object_type = /datum/orbital_object/shuttle/custom_shuttle;
	width = 13
	},
/turf/open/floor/mineral/plastitanium,
/area/shuttle/exploration)
"ai" = (
/obj/structure/chair/fancy/shuttle{
	dir = 8
	},
/obj/machinery/light/small{
	dir = 4
	},
/turf/open/floor/mineral/titanium,
/area/shuttle/exploration)
"aj" = (
/obj/effect/turf_decal/delivery,
/obj/machinery/atmospherics/pipe/manifold/purple/visible{
	dir = 1
	},
/obj/machinery/power/port_gen/pacman,
/turf/open/floor/mineral/titanium,
/area/shuttle/exploration)
"ak" = (
/obj/machinery/atmospherics/pipe/manifold/dark/hidden{
	dir = 4
	},
/turf/closed/wall/mineral/titanium/nodiagonal,
/area/shuttle/exploration)
"al" = (
/turf/template_noop,
/area/template_noop)
"am" = (
/obj/machinery/computer/objective,
/turf/open/floor/mineral/plastitanium,
/area/shuttle/exploration)
"an" = (
/obj/effect/turf_decal/delivery,
/obj/machinery/atmospherics/pipe/manifold/purple/visible{
	dir = 1
	},
/obj/structure/tank_dispenser/oxygen,
/turf/open/floor/mineral/titanium,
/area/shuttle/exploration)
"ao" = (
/obj/effect/turf_decal/delivery,
/obj/machinery/atmospherics/components/unary/plasma_refiner{
	dir = 8
	},
/turf/open/floor/mineral/titanium,
/area/shuttle/exploration)
"ap" = (
/obj/machinery/shuttle/engine/plasma{
	dir = 1
	},
/turf/open/floor/plating,
/area/shuttle/exploration)
"aq" = (
/obj/machinery/holopad,
/turf/open/floor/mineral/titanium,
/area/shuttle/exploration)
"ar" = (
/obj/effect/turf_decal/stripes/line{
	dir = 1
	},
/obj/machinery/light/small{
	dir = 1
	},
/turf/open/floor/mineral/titanium,
/area/shuttle/exploration)
"as" = (
/obj/machinery/atmospherics/pipe/simple/dark/hidden,
/turf/closed/wall/mineral/titanium,
/area/shuttle/exploration)
"at" = (
/obj/machinery/door/airlock/external/glass,
/obj/machinery/atmospherics/pipe/simple/dark/hidden{
	dir = 6
	},
/obj/docking_port/mobile{
	dir = 4;
	dwidth = 5;
	height = 7;
	id = "exploration";
	name = "Exploration Shuttle";
	port_direction = 8;
	shuttle_object_type = /datum/orbital_object/shuttle/custom_shuttle;
	width = 13
	},
/turf/open/floor/mineral/plastitanium,
/area/shuttle/exploration)
"au" = (
/obj/effect/turf_decal/stripes/line{
	dir = 1
	},
/obj/structure/cable/yellow{
	icon_state = "4-8"
	},
/turf/open/floor/mineral/titanium,
/area/shuttle/exploration)
"av" = (
/obj/machinery/atmospherics/pipe/simple/dark/hidden{
	dir = 9
	},
/turf/closed/wall/mineral/titanium/nodiagonal,
/area/shuttle/exploration)
"aw" = (
/obj/structure/window/reinforced/survival_pod{
	dir = 1
	},
/obj/machinery/atmospherics/components/unary/shuttle/engine_heater{
	dir = 1
	},
/turf/open/floor/plating,
/area/shuttle/exploration)
"ax" = (
/obj/machinery/door/airlock/external/glass,
/obj/machinery/atmospherics/pipe/simple/dark/hidden{
	dir = 10
	},
/turf/open/floor/mineral/plastitanium,
/area/shuttle/exploration)
"ay" = (
/obj/machinery/atmospherics/components/unary/tank/air{
	dir = 4;
	initialize_directions = 4
	},
/turf/open/floor/mineral/plastitanium,
/area/shuttle/exploration)
"az" = (
/turf/closed/wall/mineral/titanium/nodiagonal,
/area/shuttle/exploration)
"aA" = (
/obj/structure/fans/tiny,
/obj/effect/turf_decal/stripes/line{
	dir = 8
	},
/obj/effect/turf_decal/stripes/line{
	dir = 4
	},
/obj/machinery/door/poddoor/shutters{
	id = "exploration"
	},
/turf/open/floor/mineral/titanium,
/area/shuttle/exploration)
"aB" = (
/obj/effect/turf_decal/stripes/line{
	dir = 1
	},
/obj/machinery/power/apc/auto_name/north{
	pixel_y = 24
	},
/obj/structure/cable/yellow{
	icon_state = "0-4"
	},
/turf/open/floor/mineral/titanium,
/area/shuttle/exploration)
"aC" = (
/obj/effect/turf_decal/bot,
/obj/structure/closet/crate/science,
/obj/item/circuitboard/computer/shuttle/exploration_shuttle,
/obj/item/stack/sheet/mineral/plasma/five,
/obj/item/gps/mining,
/obj/item/storage/toolbox/mechanical,
/obj/item/multitool,
/turf/open/floor/mineral/titanium,
/area/shuttle/exploration)
"aD" = (
/obj/structure/table,
/obj/machinery/recharger,
/turf/open/floor/mineral/plastitanium,
/area/shuttle/exploration)
"aE" = (
/obj/effect/turf_decal/bot,
/turf/open/floor/mineral/titanium,
/area/shuttle/exploration)
"aF" = (
/obj/structure/table,
/obj/machinery/microwave,
/obj/item/storage/box/donkpockets,
/obj/item/storage/box/donkpockets,
/turf/open/floor/mineral/plastitanium,
/area/shuttle/exploration)
"aG" = (
/obj/structure/cable/yellow,
/obj/effect/turf_decal/bot,
/turf/open/floor/plating,
/area/shuttle/exploration)
"aH" = (
/obj/machinery/atmospherics/pipe/simple/dark/hidden{
	dir = 5
	},
/turf/closed/wall/mineral/titanium/nodiagonal,
/area/shuttle/exploration)
"aI" = (
/turf/closed/wall/mineral/plastitanium,
/area/shuttle/exploration)
"aJ" = (
/obj/machinery/door/airlock/shuttle,
/obj/effect/turf_decal/stripes/line,
/obj/effect/turf_decal/stripes/line{
	dir = 1
	},
/obj/machinery/door/firedoor/border_only,
/turf/open/floor/mineral/titanium,
/area/shuttle/exploration)
"aK" = (
/obj/structure/fans/tiny,
/obj/effect/turf_decal/stripes/line{
	dir = 4
	},
/obj/effect/turf_decal/stripes/line{
	dir = 8
	},
/obj/machinery/door/poddoor/shutters{
	id = "exploration"
	},
/turf/open/floor/mineral/titanium,
/area/shuttle/exploration)
"aL" = (
/obj/structure/window/reinforced/survival_pod{
	dir = 1
	},
/obj/machinery/atmospherics/components/unary/shuttle/heater{
	dir = 1
	},
/turf/open/floor/plating,
/area/shuttle/exploration)
"aM" = (
/obj/machinery/computer/shuttle_flight/custom_shuttle/exploration,
/turf/open/floor/mineral/plastitanium,
/area/shuttle/exploration)
"aN" = (
/obj/effect/turf_decal/stripes/line{
	dir = 1
	},
/obj/structure/cable/yellow{
	icon_state = "2-8"
	},
/turf/open/floor/mineral/titanium,
/area/shuttle/exploration)
"aO" = (
/mob/living/simple_animal/chicken/turkey{
	atmos_requirements = list("min_oxy" = 0, "max_oxy" = 0, "min_tox" = 0, "max_tox" = 0, "min_co2" = 0, "max_co2" = 0, "min_n2" = 0, "max_n2" = 0);
	desc = "A veteran of Nanotrasen's Animal Experimentation Program that attempted to replicate the organic space suit that some hostile entities are known to have exhibited, Tom now serves Nanotrasen as the mascot of the Exploration Crew.";
	health = 200;
	maxHealth = 200;
	melee_damage = 5;
	minbodytemp = 2.7;
	name = "Tom"
	},
/turf/open/floor/mineral/titanium,
/area/shuttle/exploration)
"aP" = (
/obj/structure/chair/fancy/shuttle{
	dir = 1
	},
/turf/open/floor/mineral/plastitanium,
/area/shuttle/exploration)
"aQ" = (
/turf/closed/wall/mineral/titanium,
/area/shuttle/exploration)
"aR" = (
/obj/effect/spawner/structure/window/shuttle,
/turf/open/floor/plating,
/area/shuttle/exploration)
"aS" = (
/obj/machinery/door/airlock/shuttle,
/obj/effect/turf_decal/stripes/line,
/obj/effect/turf_decal/stripes/line{
	dir = 1
	},
/obj/machinery/door/firedoor/border_only,
/obj/machinery/door/firedoor/border_only{
	dir = 1
	},
/turf/open/floor/mineral/plastitanium,
/area/shuttle/exploration)
"aT" = (
/obj/effect/turf_decal/bot,
/obj/machinery/portable_atmospherics/canister/toxins,
/turf/open/floor/mineral/titanium,
/area/shuttle/exploration)
"aU" = (
/obj/effect/turf_decal/delivery,
/obj/machinery/atmospherics/components/unary/portables_connector/visible{
	dir = 4
	},
/turf/open/floor/mineral/titanium,
/area/shuttle/exploration)
"aV" = (
/obj/effect/turf_decal/stripes/line{
	dir = 1
	},
/turf/open/floor/mineral/titanium,
/area/shuttle/exploration)
"aW" = (
/turf/closed/wall/mineral/plastitanium/nodiagonal,
/area/shuttle/exploration)
"aX" = (
/obj/structure/chair/fancy/shuttle{
	dir = 8
	},
/turf/open/floor/mineral/titanium,
/area/shuttle/exploration)
"aY" = (
/obj/effect/turf_decal/delivery,
/obj/machinery/telecomms/relay/preset/exploration,
/turf/open/floor/mineral/titanium,
/area/shuttle/exploration)
"aZ" = (
/obj/structure/closet/emcloset/anchored,
/obj/machinery/advanced_airlock_controller/directional/east,
/obj/machinery/light/small{
	dir = 1
	},
/turf/open/floor/mineral/plastitanium,
/area/shuttle/exploration)
"AH" = (
/obj/machinery/computer/locator,
/turf/open/floor/mineral/plastitanium,
/area/shuttle/exploration)
"HN" = (
/obj/machinery/door/airlock/shuttle,
/obj/effect/turf_decal/stripes/line,
/obj/effect/turf_decal/stripes/line{
	dir = 1
	},
/obj/machinery/door/firedoor/border_only,
/turf/open/floor/mineral/plastitanium,
/area/shuttle/exploration)

(1,1,1) = {"
al
aR
aR
aQ
aQ
ah
as
aH
ae
aK
aQ
aI
al
"}
(2,1,1) = {"
aR
aR
aD
az
aZ
ac
ay
af
aB
aC
aU
aW
aI
"}
(3,1,1) = {"
aR
aM
aP
az
az
ax
ak
av
au
aE
an
aw
ap
"}
(4,1,1) = {"
aR
AH
ad
HN
ag
ag
aY
aR
aN
aG
aj
aw
ap
"}
(5,1,1) = {"
aR
am
aP
az
aO
aq
ag
aJ
aV
aE
ab
aw
ap
"}
(6,1,1) = {"
aR
aR
aF
az
ai
aX
ai
az
ar
aT
ao
aW
aI
"}
(7,1,1) = {"
al
aR
aR
aQ
aQ
aR
aQ
az
ae
aA
aQ
aI
al
"}
