//MAP CONVERTED BY dmm2tgm.py THIS HEADER COMMENT PREVENTS RECONVERSION, DO NOT REMOVE
"bp" = (
/obj/structure/window/reinforced/survival_pod{
	dir = 1
	},
/obj/machinery/atmospherics/components/unary/shuttle/engine_heater{
	dir = 1
	},
/turf/open/floor/plating,
/area/shuttle/exploration)
"br" = (
/obj/effect/turf_decal/stripes/line{
	dir = 1
	},
/obj/effect/decal/cleanable/blood/old,
/obj/effect/turf_decal/tile/blue/opposingcorners,
/turf/open/floor/mineral/titanium/white,
/area/shuttle/exploration)
"bt" = (
/obj/machinery/light,
/obj/item/kirbyplants{
	icon_state = "plant-03"
	},
/obj/effect/turf_decal/tile/blue/opposingcorners,
/turf/open/floor/mineral/titanium/white,
/area/shuttle/exploration)
"ct" = (
/obj/effect/turf_decal/stripes/line,
/obj/effect/turf_decal/tile/blue/opposingcorners,
/turf/open/floor/mineral/titanium/white,
/area/shuttle/exploration)
"cT" = (
/obj/machinery/holopad{
	pixel_x = 15
	},
/obj/effect/turf_decal/box/corners{
	dir = 1
	},
/obj/effect/turf_decal/box/corners{
	dir = 8
	},
/obj/effect/turf_decal/tile/neutral/fourcorners/contrasted,
/turf/open/floor/mineral/plastitanium,
/area/shuttle/exploration)
"eh" = (
/obj/effect/turf_decal/tile/blue/opposingcorners,
/turf/open/floor/mineral/titanium/white,
/area/shuttle/exploration)
"eW" = (
/obj/structure/cable/yellow{
	icon_state = "2-4"
	},
/obj/effect/turf_decal/tile/brown/opposingcorners,
/turf/open/floor/mineral/titanium/yellow,
/area/shuttle/exploration)
"gl" = (
/obj/machinery/door/poddoor/shutters{
	id = "exploration"
	},
/obj/effect/turf_decal/stripes/line{
	dir = 8
	},
/obj/effect/turf_decal/stripes/line{
	dir = 4
	},
/obj/effect/turf_decal/delivery,
/obj/structure/fans/tiny,
/turf/open/floor/plating,
/area/shuttle/exploration)
"gs" = (
/obj/machinery/atmospherics/components/unary/plasma_refiner{
	dir = 8
	},
/obj/effect/turf_decal/delivery,
/obj/effect/turf_decal/tile/brown/opposingcorners,
/turf/open/floor/mineral/titanium/yellow,
/area/shuttle/exploration)
"kp" = (
/obj/effect/turf_decal/stripes/line{
	dir = 8
	},
/obj/effect/turf_decal/caution/stand_clear{
	dir = 4
	},
/obj/effect/turf_decal/tile/brown/opposingcorners,
/turf/open/floor/mineral/titanium/yellow,
/area/shuttle/exploration)
"kW" = (
/obj/item/kirbyplants{
	icon_state = "applebush"
	},
/obj/machinery/light{
	dir = 8
	},
/obj/effect/turf_decal/tile/blue/opposingcorners,
/turf/open/floor/mineral/titanium/white,
/area/shuttle/exploration)
"na" = (
/obj/effect/turf_decal/box/corners{
	dir = 4
	},
/obj/effect/turf_decal/box/corners,
/obj/effect/turf_decal/tile/neutral/fourcorners/contrasted,
/turf/open/floor/mineral/plastitanium,
/area/shuttle/exploration)
"nW" = (
/obj/effect/turf_decal/delivery,
/obj/structure/table/reinforced,
/obj/effect/turf_decal/stripes/line{
	dir = 9
	},
/obj/item/storage/box/donkpockets,
/obj/item/storage/box/donkpockets/donkpockethonk{
	pixel_x = 5;
	pixel_y = 5
	},
/obj/effect/turf_decal/tile/neutral/opposingcorners,
/turf/open/floor/mineral/plastitanium,
/area/shuttle/exploration)
"pt" = (
/obj/machinery/power/port_gen/pacman,
/obj/machinery/atmospherics/pipe/manifold/purple/visible{
	dir = 1
	},
/obj/structure/cable/yellow,
/obj/effect/turf_decal/tile/brown/opposingcorners,
/turf/open/floor/mineral/titanium/yellow,
/area/shuttle/exploration)
"qA" = (
/obj/item/trash/pistachios,
/obj/effect/turf_decal/tile/blue/opposingcorners,
/turf/open/floor/mineral/titanium/white,
/area/shuttle/exploration)
"qJ" = (
/obj/effect/turf_decal/stripes/line{
	dir = 8
	},
/obj/effect/turf_decal/tile/neutral/opposingcorners,
/turf/open/floor/mineral/plastitanium,
/area/shuttle/exploration)
"rh" = (
/obj/machinery/button/door{
	desc = "A remote control switch.";
	id = "exploration";
	name = "Exploration Shuttle Shutters";
	pixel_y = 8
	},
/turf/closed/wall/mineral/titanium/nodiagonal,
/area/shuttle/exploration)
"rr" = (
/obj/effect/turf_decal/tile/brown/opposingcorners,
/turf/open/floor/mineral/titanium/yellow,
/area/shuttle/exploration)
"si" = (
/obj/structure/sign/warning/fire,
/turf/closed/wall/mineral/plastitanium/nodiagonal,
/area/shuttle/exploration)
"sX" = (
/obj/effect/turf_decal/stripes/line{
	dir = 4
	},
/obj/effect/turf_decal/tile/neutral/opposingcorners,
/turf/open/floor/mineral/plastitanium,
/area/shuttle/exploration)
"un" = (
/obj/effect/turf_decal/stripes/line{
	dir = 8
	},
/obj/effect/turf_decal/caution/red{
	dir = 4
	},
/obj/effect/turf_decal/box/corners{
	dir = 4
	},
/obj/effect/turf_decal/tile/blue/opposingcorners,
/turf/open/floor/mineral/titanium/white,
/area/shuttle/exploration)
"vf" = (
/obj/structure/sign/nanotrasen,
/turf/closed/wall/mineral/titanium,
/area/shuttle/exploration)
"wi" = (
/obj/structure/closet/crate/bin,
/obj/effect/turf_decal/delivery,
/obj/item/toy/beach_ball,
/obj/item/bikehorn/rubberducky,
/obj/effect/turf_decal/tile/blue/opposingcorners,
/turf/open/floor/mineral/titanium/white,
/area/shuttle/exploration)
"wG" = (
/turf/closed/wall/mineral/titanium,
/area/shuttle/exploration)
"yt" = (
/obj/machinery/atmospherics/pipe/manifold/purple/visible{
	dir = 1
	},
/obj/item/radio/headset/headset_exploration,
/obj/item/radio/headset/headset_exploration,
/obj/structure/closet/crate/science,
/obj/item/multitool,
/obj/item/wrench,
/obj/item/stack/sheet/mineral/plasma/twenty,
/obj/item/mining_scanner,
/obj/item/pickaxe,
/obj/effect/turf_decal/tile/brown/opposingcorners,
/turf/open/floor/mineral/titanium/yellow,
/area/shuttle/exploration)
"AE" = (
/turf/closed/wall/mineral/titanium/nodiagonal,
/area/shuttle/exploration)
"AZ" = (
/obj/effect/spawner/structure/window/shuttle,
/turf/open/floor/plating,
/area/shuttle/exploration)
"Cg" = (
/obj/effect/turf_decal/stripes/line{
	dir = 8
	},
/obj/effect/turf_decal/caution/red{
	dir = 4
	},
/obj/effect/turf_decal/box/corners,
/obj/effect/turf_decal/tile/blue/opposingcorners,
/turf/open/floor/mineral/titanium/white,
/area/shuttle/exploration)
"Dn" = (
/obj/machinery/microwave{
	pixel_y = 6
	},
/obj/structure/table/reinforced,
/obj/effect/turf_decal/tile/blue/opposingcorners,
/turf/open/floor/mineral/titanium/white,
/area/shuttle/exploration)
"Eh" = (
/obj/item/kirbyplants{
	icon_state = "plant-21"
	},
/obj/machinery/light{
	dir = 4
	},
/obj/effect/turf_decal/tile/blue/opposingcorners,
/turf/open/floor/mineral/titanium/white,
/area/shuttle/exploration)
"EO" = (
/obj/effect/turf_decal/stripes/line{
	dir = 1
	},
/obj/effect/turf_decal/tile/blue/opposingcorners,
/turf/open/floor/mineral/titanium/white,
/area/shuttle/exploration)
"GW" = (
/obj/effect/turf_decal/tile/brown,
/obj/effect/turf_decal/tile/brown{
	dir = 1
	},
/obj/machinery/power/apc/auto_name/east{
	pixel_x = 24
	},
/obj/structure/cable/yellow{
	icon_state = "0-8"
	},
/obj/effect/turf_decal/loading_area,
/obj{
	name = "---Merge conflict marker---"
	},
/obj/machinery/power/apc/auto_name/east,
/obj/structure/cable/yellow{
	icon_state = "0-8"
	},
/obj/effect/turf_decal/loading_area,
/obj/effect/turf_decal/tile/brown/opposingcorners,
/turf/open/floor/mineral/titanium/yellow,
/area/shuttle/exploration)
"Kl" = (
/obj/structure/table/reinforced,
/obj/item/flashlight/lamp/green{
	on = 0;
	pixel_x = -3;
	pixel_y = 8
	},
/obj/effect/turf_decal/tile/neutral/opposingcorners,
/turf/open/floor/mineral/plastitanium,
/area/shuttle/exploration)
"LX" = (
/obj/effect/turf_decal/delivery,
/obj/effect/turf_decal/tile/neutral{
	dir = 1
	},
/obj/effect/turf_decal/stripes/line{
	dir = 1
	},
/obj/effect/turf_decal/tile/neutral,
/obj/effect/turf_decal/tile/neutral{
	dir = 1
	},
/obj/machinery/computer/locator,
/obj{
	name = "---Merge conflict marker---"
	},
/obj/effect/turf_decal/delivery,
/obj/machinery/computer/objective,
/obj/effect/turf_decal/stripes/line{
	dir = 1
	},
/obj/effect/turf_decal/tile/neutral/opposingcorners,
/turf/open/floor/mineral/plastitanium,
/area/shuttle/exploration)
"NL" = (
/obj/structure/lattice/catwalk,
/obj/item/stack/marker_beacon{
	anchored = 1;
	icon_state = "markerburgundy-on";
	light_color = "#FA644B";
	light_power = 3;
	light_range = 2;
	name = "landing marker";
	picked_color = "Burgundy"
	},
/turf/template_noop,
/area/shuttle/exploration)
"PK" = (
/obj/machinery/shuttle/engine/plasma{
	dir = 1
	},
/turf/open/floor/plating,
/area/shuttle/exploration)
"Qu" = (
/obj/machinery/telecomms/relay/preset/exploration,
/obj/effect/turf_decal/delivery,
/turf/open/floor/mineral/plastitanium,
/area/shuttle/exploration)
"QY" = (
/obj/machinery/door/airlock/external/glass,
/obj/structure/fans/tiny,
/obj/docking_port/mobile{
	dir = 4;
	dwidth = 10;
	faction_type = /datum/faction/station;
	height = 9;
	id = "exploration";
	name = "Exploration Shuttle";
	port_direction = 8;
	shuttle_object_type = /datum/orbital_object/shuttle/custom_shuttle;
	width = 15
	},
/turf/open/floor/mineral/plastitanium,
/area/shuttle/exploration)
"Rk" = (
/obj/effect/turf_decal/stripes/line{
	dir = 8
	},
/obj/effect/turf_decal/caution/red{
	dir = 4
	},
/obj/effect/turf_decal/tile/blue/opposingcorners,
/turf/open/floor/mineral/titanium/white,
/area/shuttle/exploration)
"RK" = (
/obj/effect/turf_decal/delivery,
/obj/machinery/computer/shuttle_flight/custom_shuttle/exploration,
/obj/effect/turf_decal/stripes/line{
	dir = 1
	},
/obj/effect/turf_decal/tile/neutral/opposingcorners,
/turf/open/floor/mineral/plastitanium,
/area/shuttle/exploration)
"Sw" = (
/obj/effect/turf_decal/stripes/corner{
	dir = 1
	},
/obj/machinery/atmospherics/components/unary/portables_connector/visible{
	dir = 4
	},
/obj/effect/turf_decal/delivery,
/obj/machinery/light{
	dir = 8;
	light_color = "#e8eaff"
	},
/obj/effect/turf_decal/tile/brown/opposingcorners,
/turf/open/floor/mineral/titanium/yellow,
/area/shuttle/exploration)
"SG" = (
/obj/effect/turf_decal/stripes/corner{
	dir = 8
	},
/obj/effect/turf_decal/tile/blue/opposingcorners,
/turf/open/floor/mineral/titanium/white,
/area/shuttle/exploration)
"SV" = (
/obj/effect/turf_decal/delivery,
/obj/structure/table/reinforced,
/obj/item/tank/internals/emergency_oxygen/engi{
	pixel_x = -10;
	pixel_y = 3
	},
/obj/item/storage/toolbox/emergency,
/obj/item/radio{
	pixel_x = 7;
	pixel_y = 8
	},
/obj/effect/turf_decal/stripes/line{
	dir = 5
	},
/obj/effect/turf_decal/tile/neutral/opposingcorners,
/turf/open/floor/mineral/plastitanium,
/area/shuttle/exploration)
"Tw" = (
/obj/structure/chair/fancy/shuttle{
	dir = 1
	},
/obj/effect/turf_decal/tile/neutral/opposingcorners,
/turf/open/floor/mineral/plastitanium,
/area/shuttle/exploration)
"Tz" = (
/obj/effect/turf_decal/tile/neutral/opposingcorners,
/turf/open/floor/mineral/plastitanium,
/area/shuttle/exploration)
"TL" = (
/obj/structure/chair/fancy/shuttle,
/obj/effect/turf_decal/tile/neutral/opposingcorners,
/turf/open/floor/mineral/plastitanium,
/area/shuttle/exploration)
"Us" = (
/obj/machinery/light,
/obj/item/kirbyplants{
	icon_state = "plant-10"
	},
/obj/effect/turf_decal/stripes/corner{
	dir = 1
	},
/obj/structure/sign/warning/vacuum/external{
	pixel_y = -32
	},
/obj/effect/turf_decal/tile/blue/opposingcorners,
/turf/open/floor/mineral/titanium/white,
/area/shuttle/exploration)
"Vg" = (
/turf/closed/wall/mineral/plastitanium,
/area/shuttle/exploration)
"Wk" = (
/obj/machinery/atmospherics/pipe/manifold/purple/visible{
	dir = 1
	},
/obj/effect/turf_decal/tile/brown/opposingcorners,
/turf/open/floor/mineral/titanium/yellow,
/area/shuttle/exploration)
"Xu" = (
/obj/effect/decal/remains/human,
/obj/effect/decal/cleanable/blood/old,
/obj/effect/turf_decal/tile/neutral/opposingcorners,
/turf/open/floor/mineral/plastitanium,
/area/shuttle/exploration)
"YB" = (
/obj/machinery/recharger{
	pixel_x = 6
	},
/obj/machinery/recharger{
	pixel_x = -6
	},
/obj/structure/table/reinforced,
/obj/effect/turf_decal/tile/neutral/opposingcorners,
/turf/open/floor/mineral/plastitanium,
/area/shuttle/exploration)

(1,1,1) = {"
NL
AZ
wG
wG
vf
gl
gl
gl
AZ
wG
QY
rh
Vg
NL
"}
(2,1,1) = {"
AZ
AZ
Dn
kW
SG
un
Rk
Cg
Us
wG
kp
Sw
si
Vg
"}
(3,1,1) = {"
AZ
nW
qJ
qJ
qJ
qJ
EO
qA
eh
ct
rr
Wk
bp
PK
"}
(4,1,1) = {"
AZ
RK
Tz
TL
YB
Tw
EO
cT
eh
ct
rr
yt
bp
PK
"}
(5,1,1) = {"
AZ
LX
Xu
TL
Kl
Tw
EO
na
eh
ct
rr
Wk
bp
PK
"}
(6,1,1) = {"
AZ
SV
sX
sX
sX
sX
br
eh
eh
ct
eW
pt
bp
PK
"}
(7,1,1) = {"
AZ
AZ
Qu
Eh
eh
eh
eh
wi
bt
wG
GW
gs
si
Vg
"}
(8,1,1) = {"
NL
AZ
AZ
wG
vf
AZ
AZ
wG
wG
wG
wG
AE
Vg
NL
"}
